sentence	label_name	Language	label_ID
Однополые браки имеют положительные экономические последствия, такие как увеличение доходов от туристов и разрешений на брак, а также расходов, связанных с браком.	Economic	ru	1.0
Противники однополых браков утверждают, что это приведет к негативным экономическим последствиям, таким как ослабление традиционных семейных структур и, как следствие, социальная нестабильность.	Economic	ru	1.0
Легализация однополых браков поможет однополым парам получить доступ к тем же ресурсам и преимуществам, что и гетеросексуальные пары, например b. Права на здоровье и права наследования	Capacity and Resources	ru	2.0
Некоторые противники однополых браков утверждают, что это ослабит способность государственных органов и учреждений признавать и признавать однополые браки.	Capacity and Resources	ru	2.0
Сторонники однополых браков утверждают, что это основное право человека и что отказ однополым парам в праве на брак является аморальным.	Morality	ru	3.0
Противники однополых браков часто основывают свои аргументы на религиозных или моральных соображениях, утверждая, что брак должен заключаться только между мужчиной и женщиной.	Morality	ru	3.0
Легализация однополых браков часто рассматривается как вопрос справедливости и равенства, дающий однополым парам такое же юридическое признание и преимущества, как и гетеросексуальным парам.	Fairness and Equality	ru	4.0
Противники однополых браков утверждают, что это не равенство, потому что однополые пары могут вступать в зарегистрированные или однополые партнерства, что дает им те же юридические права, что и супружеским парам.	Fairness and Equality	ru	4.0
Правовой статус однополых браков зависит от юрисдикции. Некоторые страны и штаты легализуют его, а другие нет. Это вызвало дебаты по таким вопросам, как права штатов и роль федерального правительства в определении брака.	Legality, Constitutionality, Jurisdiction	ru	5.0
Противники однополых браков обычно утверждают, что штаты должны решать, легализовать их или нет, в то время как сторонники обычно утверждают, что это вопрос федеральных конституционных прав.	Legality, Constitutionality, Jurisdiction	ru	5.0
Сторонники однополых браков рассматривают легализацию однополых браков как положительный политический шаг на пути к большему равенству и инклюзивности.	Policy Prescription and Evaluation	ru	6.0
Противники однополых браков утверждают, что они имеют негативные социальные и культурные последствия и не обеспечивают жизнеспособного политического решения проблем, с которыми сталкиваются однополые пары.	Policy Prescription and Evaluation	ru	6.0
Легализация однополых браков не имеет уголовных или уголовных последствий.	Crime and Punishment	ru	7.0
Однако противники однополых браков часто утверждают, что они разрушат традиционные семейные ценности и моральные устои, что, по их словам, будет иметь негативные социальные последствия.	Crime and Punishment	ru	7.0
Легализация однополых браков не имеет никаких последствий для безопасности.	Security and Defense	ru	8.0
Но некоторые противники однополых браков говорят, что они подрывают традиционные семейные структуры, которые, по их словам, необходимы для укрепления социальных ценностей и национальной обороны.	Security and Defense	ru	8.0
Легализация однополых браков оказала положительное влияние на здоровье и безопасность, предоставив однополым парам доступ к важным юридическим и медицинским льготам, таким как медицинское страхование и право на посещение больницы.	Health and Safety	ru	9.0
Противники однополых браков утверждают, что они могут иметь негативные последствия для здоровья, в том числе:	Health and Safety	ru	9.0
Легализация однополых браков окажет положительное влияние на качество жизни однополых пар, обеспечив более широкое юридическое признание и доступ к важным преимуществам и ресурсам.	Quality of Life	ru	10.0
Противники однополых браков часто утверждают, что они разрушают традиционные семейные структуры и ценности, негативно влияя на качество жизни отдельных людей и семей.	Quality of Life	ru	10.0
Однополые браки можно рассматривать как отражение изменения культурного отношения к правам и признанию ЛГБТК+.	Cultural Identity	ru	11.0
Противники однополых браков часто спорят о сохранении традиционных культурных ценностей и норм.	Cultural Identity	ru	11.0
Общественное мнение об однополых браках резко изменилось за последние годы, поскольку растет поддержка юридического признания однополых отношений.	Public Sentiment	ru	12.0
Однако некоторые противники однополых браков утверждают, что общественное мнение не должно влиять на политические решения и что брак должен определяться как брак между мужчиной и женщиной.	Public Sentiment	ru	12.0
Однополые браки - это очень политический вопрос, и разные политические партии и группы интересов занимают разные позиции по этому вопросу.	Political	ru	13.0
Законность однополых браков часто становится политическим вопросом во время выборов, поскольку кандидаты комментируют свои платформы.	Political	ru	13.0
Правовой статус однополых браков может повлиять на международное положение страны, особенно на ее позицию в отношении прав человека и вопросов ЛГБТК+.	External Regulation and Reputation	ru	14.0
Некоторые противники однополых браков утверждают, что они наносят ущерб имиджу страны и ее отношениям с другими странами.	External Regulation and Reputation	ru	14.0
Однополые браки связаны со многими другими проблемами, такими как усыновление и опека над детьми, дискриминация и преступления на почве ненависти, а также неравенство в отношении здоровья.	Other	ru	15.0
Дебаты вокруг однополых браков сложны и многогранны, часто с участием различных групп интересов и точек зрения.	Other	ru	15.0
Иммиграция оказывает как положительное, так и отрицательное влияние на экономику, хотя она вносит свой вклад в экономику через занятость и потребление, она также потребляет общественные ресурсы.	Economic	ru	1.0
Некоторые утверждают, что иммиграция необходима для экономического роста, особенно в секторах с нехваткой рабочей силы, в то время как другие утверждают, что из-за нее местные рабочие теряют работу.	Economic	ru	1.0
Миграция оказывает давление на государственные ресурсы, такие как здравоохранение, образование и жилье, особенно в районах с большим количеством мигрантов.	Capacity and Resources	ru	2.0
Но некоторые утверждают, что иммигранты также приносят с собой навыки и способности, которые приносят пользу обществу и способствуют развитию этих активов.	Capacity and Resources	ru	2.0
Мораль иммиграции является спорным вопросом: некоторые утверждают, что предоставление защиты и возможностей нуждающимся является моральным императивом, в то время как другие считают аморальным позволять иммигрантам без документов оставаться в стране.	Morality	ru	3.0
Дебаты об иммиграции часто вращаются вокруг вопросов справедливости и равенства. Некоторые утверждают, что несправедливо отдавать предпочтение потребностям иммигрантов над потребностями коренных граждан, в то время как другие утверждают, что иммигранты должны иметь равные возможности независимо от национальности.	Fairness and Equality	ru	4.0
Законность иммиграции является сложным вопросом, поскольку различные законы и положения регулируют различные типы иммиграции и виз.	Legality, Constitutionality, Jurisdiction	ru	5.0
Некоторые считают иммиграционную политику неконституционной или несправедливой, в то время как другие считают важным обеспечивать и защищать национальную безопасность.	Legality, Constitutionality, Jurisdiction	ru	5.0
Эффективность различных иммиграционных политик и программ является предметом постоянных дискуссий, поскольку разные заинтересованные стороны предлагают разные решения иммиграционных проблем и возможностей.	Policy Prescription and Evaluation	ru	6.0
Оценка важна для обеспечения эффективности и справедливости иммиграционной политики и программ.	Policy Prescription and Evaluation	ru	6.0
Связь между иммиграцией и преступностью противоречива: некоторые утверждают, что иммигранты с большей вероятностью совершают преступления и представляют угрозу общественной безопасности, в то время как другие утверждают, что иммигранты с меньшей вероятностью совершают преступления, чем коренные граждане.	Crime and Punishment	ru	7.0
Иммиграция имеет значение для национальной безопасности и национальной безопасности, особенно для проверки и проверки иммигрантов и предотвращения въезда потенциальных угроз.	Security and Defense	ru	8.0
Но некоторые утверждают, что чрезмерно ограничительная иммиграционная политика может повредить отношениям с другими странами и ограничить возможности для сотрудничества и инноваций.	Security and Defense	ru	8.0
Миграция имеет последствия для общественного здравоохранения и безопасности, особенно с точки зрения распространения болезней и доступа к здравоохранению.	Health and Safety	ru	9.0
Однако некоторые утверждают, что предоставление медицинских и социальных услуг может улучшить общие результаты общественного здравоохранения и снизить нагрузку на службы неотложной помощи.	Health and Safety	ru	9.0
Миграция может иметь как положительное, так и отрицательное влияние на качество жизни как мигрантов, так и местных жителей, в зависимости от таких факторов, как экономический статус, социальная сплоченность и культурная самобытность.	Quality of Life	ru	10.0
Некоторые утверждают, что иммиграция способствует разнообразию и культурному обмену, в то время как другие считают, что она привела к социальному и экономическому разделению.	Quality of Life	ru	10.0
Миграция влияет на культурную самобытность, особенно с точки зрения языка, традиций и ценностей.	Cultural Identity	ru	11.0
Некоторые утверждают, что иммиграция может обогатить и разнообразить культурный опыт, в то время как другие утверждают, что она может подорвать национальную идентичность и социальную сплоченность.	Cultural Identity	ru	11.0
Общественное мнение об иммиграции было поляризованным: одни выражали поддержку большей иммиграции, другие призывали к усилению контроля и ограничений.	Public Sentiment	ru	12.0
То, как средства массовой информации и политики изображают иммигрантов, может влиять на общественное мнение и политические решения.	Public Sentiment	ru	12.0
Иммиграция — это очень политический вопрос, и разные политические партии и группы интересов занимают разные позиции по этому вопросу.	Political	ru	13.0
Дебаты об иммиграции часто становятся политическим вопросом во время выборов, и кандидаты занимают позиции по этому вопросу на своих собственных платформах.	Political	ru	13.0
То, как страна справляется с иммиграцией, может повлиять на ее репутацию и отношения с другими странами, особенно когда речь идет о правах человека и международном праве.	External Regulation and Reputation	ru	14.0
На модели миграции также влияют внешнее давление и правила международных организаций и договоров.	External Regulation and Reputation	ru	14.0
Другие вопросы иммиграции включают влияние на динамику семьи, роль иммигрантов в формировании демографических тенденций и культурного обмена, а также интеграцию иммигрантов в общество.	Other	ru	15.0
Эти вопросы оказывают значительное влияние на социальную, экономическую и политическую динамику страны.	Other	ru	15.0
Однополые браки могут оказать положительное экономическое влияние за счет развития местного бизнеса и туризма, а также увеличения государственных налоговых поступлений.	Economic	ru	1.0
Противники говорят, что однополые браки разрушают традиционные структуры брака и семьи и негативно сказываются на экономике.	Economic	ru	1.0
Легализация однополых браков расширила бы доступ однополых пар к ресурсам и благам, таким как здравоохранение и родительские права.	Capacity and Resources	ru	2.0
Критики утверждают, что однополые браки требуют ресурсов и власти, поскольку требуют изменений в правовой базе и институтах.	Capacity and Resources	ru	2.0
Сторонники однополых браков утверждают, что признание равных прав и достоинства всех людей независимо от сексуальной ориентации является моральным императивом.	Morality	ru	3.0
Противники утверждают, что однополые браки аморальны и нарушают традиционные религиозные и культурные ценности.	Morality	ru	3.0
Однополые браки считаются важным вопросом справедливости и равенства для ЛГБТК + людей, предлагая те же права и юридическую защиту, что и гетеросексуальные пары.	Fairness and Equality	ru	4.0
Критики утверждают, что однополые браки не являются вопросом равенства, поскольку требуют переопределения традиционного определения брака.	Fairness and Equality	ru	4.0
Законность однополых браков обсуждалась в судах и правительствах, различающихся толкованием конституции и судебным мнением.	Legality, Constitutionality, Jurisdiction	ru	5.0
Противники утверждают, что однополые браки не должны быть легализованы, потому что ни Конституция, ни прецедент четко не предписывают однополые браки.	Legality, Constitutionality, Jurisdiction	ru	5.0
Параметры политики в отношении однополых браков различаются в зависимости от политических и культурных факторов. В одних странах это легализуется, в других - запрещается.	Policy Prescription and Evaluation	ru	6.0
Оценка социальных и личных последствий однополых браков является постоянным процессом, и исследования показывают как положительные, так и отрицательные результаты.	Policy Prescription and Evaluation	ru	6.0
В некоторых юрисдикциях однополые браки криминализированы, и люди сталкиваются с юридическими санкциями или общественным осуждением за однополые отношения.	Crime and Punishment	ru	7.0
Усилия по легализации однополых браков часто рассматриваются как способ положить конец дискриминации и наказанию по признаку сексуальной ориентации.	Crime and Punishment	ru	7.0
Однополые браки использовались как инструмент для продвижения национальной безопасности и прав человека, особенно в контексте международных отношений и дипломатии.	Security and Defense	ru	8.0
Критики считают, что однополые браки подрывают институт брака и семьи и негативно влияют на национальную безопасность и социальную стабильность.	Security and Defense	ru	8.0
Легализация однополых браков может улучшить здоровье и безопасность ЛГБТК+ людей, предоставив им доступ к здравоохранению, страховке и правовой защите.	Health and Safety	ru	9.0
Противники говорят, что однополые браки вредны для здоровья человека и общества, приводят к распространению болезней и другим негативным последствиям.	Health and Safety	ru	9.0
Благодаря юридическому и социальному признанию ЛГБТК+, однополые браки считаются важным фактором улучшения качества жизни ЛГБТК+.	Quality of Life	ru	10.0
Критики утверждают, что однополые браки подрывают традиционные ценности и структуры, негативно влияя на качество жизни отдельных людей и обществ.	Quality of Life	ru	10.0
Однополые браки считаются центральным вопросом культурной идентичности ЛГБТК +, поскольку они представляют собой фундаментальное признание их существования и прав в обществе.	Cultural Identity	ru	11.0
Противники утверждают, что однополые браки угрожают традиционным культурным идентичностям и ценностям и могут привести к социальной и моральной деградации.	Cultural Identity	ru	11.0
Со временем общественное мнение об однополых браках изменилось, и все больше и больше стран и территорий принимают и поддерживают однополые браки.	Public Sentiment	ru	12.0
Стремление легализовать однополые браки часто обусловлено общественным мнением, когда политики и организации реагируют на меняющиеся взгляды и идеи.	Public Sentiment	ru	12.0
Проблема однополых браков часто носит политический характер, и политические партии и политики занимают разные позиции в зависимости от своих ценностей и идеологий.	Political	ru	13.0
Легализация однополых браков стала важным политическим вопросом для активистов за права ЛГБТК+, которые видят в этом способ достижения большего социального и юридического равенства.	Political	ru	13.0
Однополые браки часто рассматривают как меру приверженности страны социальному прогрессу и правам человека, но международные группы и их союзники лоббируют в правительстве их легализацию.	External Regulation and Reputation	ru	14.0
Оппоненты утверждают, что внешнее давление с целью легализации однополых браков нарушает национальный суверенитет и культурные ценности.	External Regulation and Reputation	ru	14.0
Однополые браки — очень противоречивая и эмоциональная проблема, когда отдельные лица и группы с обеих сторон борются за свои убеждения и ценности.	Other	ru	15.0
Дебаты вокруг однополых браков сложны и многогранны, отражая более широкую социальную и культурную напряженность вокруг идентичности, ценностей и власти.	Other	ru	15.0
Иммиграция имеет как положительные, так и отрицательные экономические последствия: одни утверждают, что она приносит ценную рабочую силу и навыки, в то время как другие утверждают, что она снижает заработную плату и наносит ущерб социальным услугам.	Economic	ru	1.0
Многие компании полагаются на трудовых мигрантов, особенно в таких секторах, как сельское хозяйство, гостиничный бизнес и строительство.	Economic	ru	1.0
Миграция оказывает давление на инфраструктуру и ресурсы страны, такие как жилье, транспорт и здравоохранение, особенно в районах с высоким спросом на услуги.	Capacity and Resources	ru	2.0
Многие страны ограничивают количество иммигрантов, которых они могут принять, исходя из их ресурсов и способности оказать помощь.	Capacity and Resources	ru	2.0
Некоторые рассматривают иммиграцию как моральное обязательство помогать нуждающимся, особенно беженцам, спасающимся от насилия или преследований в своих странах.	Morality	ru	3.0
Другие утверждают, что разрешение иммигрантам нелегально въезжать или эксплуатировать рабочих-мигрантов неэтично.	Morality	ru	3.0
Многие утверждают, что иммиграционная политика должна основываться на принципах справедливости и равенства и что к иммигрантам следует относиться с достоинством и уважением.	Fairness and Equality	ru	4.0
Другие утверждают, что отдавать предпочтение иммигрантам над гражданами несправедливо и несправедливо.	Fairness and Equality	ru	4.0
Иммиграционная политика сталкивается с правовыми и конституционными проблемами, особенно в вопросах гражданства, депортации и предоставления убежища.	Legality, Constitutionality, Jurisdiction	ru	5.0
Многие страны имеют юрисдикционные различия, при этом местные, государственные и федеральные правительства играют роль в иммиграционной политике.	Legality, Constitutionality, Jurisdiction	ru	5.0
Иммиграционная политика часто определяется формулированием и оценкой политики, когда эксперты и лица, определяющие политику, взвешивают затраты и преимущества различных подходов.	Policy Prescription and Evaluation	ru	6.0
Некоторые утверждают, что стратегия должна основываться на фактических данных и данных, в то время как другие подчеркивают теоретические или политические причины.	Policy Prescription and Evaluation	ru	6.0
Иммиграционная политика часто связана с вопросами преступности и наказания, и некоторые утверждают, что иммигранты чаще совершают преступления и должны подвергаться более строгому контролю.	Crime and Punishment	ru	7.0
Другие утверждают, что иммигранты подвергаются несправедливому преследованию и что политика должна быть направлена ​​на снижение уровня преступности и повышение общественной безопасности для всех жителей.	Crime and Punishment	ru	7.0
Иммиграционная политика влияет на безопасность и обороноспособность страны, особенно в отношении вопросов пограничного контроля и национальной идентичности.	Security and Defense	ru	8.0
Одни видят в иммиграции угрозу национальной безопасности, другие считают ее необходимой для поддержания плюралистического и мультикультурного общества.	Security and Defense	ru	8.0
Иммиграционная политика имеет значение для общественного здравоохранения и безопасности, особенно в отношении борьбы с болезнями и вопросов реагирования на чрезвычайные ситуации.	Health and Safety	ru	9.0
Некоторые утверждают, что иммиграционная политика должна отдавать приоритет общественному здравоохранению и безопасности, в то время как другие утверждают, что политика должна отдавать приоритет потребностям иммигрантов и беженцев.	Health and Safety	ru	9.0
Иммиграционная политика влияет на качество жизни иммигрантов и граждан, особенно с точки зрения социальной сплоченности, образования и занятости.	Quality of Life	ru	10.0
Некоторые утверждают, что иммиграция улучшает качество жизни, предоставляя различные точки зрения и навыки, в то время как другие утверждают, что она создает социальную напряженность и конфликты.	Quality of Life	ru	10.0
Иммиграционная политика часто связана с вопросами культурной самобытности, и некоторые видят в иммиграции угрозу национальной самобытности и культурному наследию.	Cultural Identity	ru	11.0
Другие утверждают, что культурная самобытность постоянно развивается и что иммиграция может обогатить и разнообразить культурное самовыражение.	Cultural Identity	ru	11.0
Иммиграционная политика часто определяется общественными настроениями и отношением к иммиграции, при этом одни выступают за ужесточение ограничений, а другие за более широкую политику.	Public Sentiment	ru	12.0
На общественное мнение влияют многие факторы, включая освещение в СМИ, политический дискурс и личный опыт.	Public Sentiment	ru	12.0
На иммиграционную политику часто влияют политические взгляды, при этом разные политические партии и группы интересов занимают разные позиции в зависимости от своих ценностей и идеалов.	Political	ru	13.0
Иммиграционная политика может быть отдельным политическим вопросом, который политики используют для мобилизации своей базы и обращения к избирателям из разных демографических групп.	Political	ru	13.0
Иммиграционная политика может повлиять на внешний контроль и репутацию страны, особенно в области прав человека и международного права.	External Regulation and Reputation	ru	14.0
Некоторые утверждают, что иммиграция угрожает культурной самобытности страны, привнося новые обычаи и верования. Другие, однако, утверждают, что разнообразие обогащает культуру общества и должно поощряться.	Cultural Identity	ru	11.0
Для иммигрантов важно понимать и уважать культурную самобытность стран, которые они посещают, а также сохранять и делиться своим уникальным культурным наследием.	Cultural Identity	ru	11.0
Общественное восприятие иммиграции зависит от местоположения и контекста. В некоторых регионах иммигрантов приветствуют и ценят за услуги, которые они оказывают обществу, в то время как в других регионах люди могут бояться или возмущаться тем, что иммигранты отнимают у них работу или ресурсы.	Public Sentiment	ru	12.0
Средства массовой информации играют роль в формировании отношения общества к иммигрантам, поскольку сенсационные истории о преступлениях иммигрантов способствуют формированию негативного отношения к иммигрантам.	Public Sentiment	ru	12.0
Иммиграционная политика часто политически мотивирована: политики пытаются завоевать голоса, обращаясь к своим сторонникам или занимая жесткую позицию в отношении иммиграции.	Political	ru	13.0
Международные отношения также могут влиять на иммиграционную политику страны, поскольку дипломатические соображения и соглашения влияют на поток мигрантов.	Political	ru	13.0
Международные организации и договоры, такие как Организация Объединенных Наций и Европейский союз, играют роль в регулировании и формировании иммиграционной политики.	External Regulation and Reputation	ru	14.0
Репутация страны как гостеприимной или враждебной по отношению к иммигрантам имеет важные экономические и политические последствия, влияющие на туризм, торговлю и дипломатические отношения.	External Regulation and Reputation	ru	14.0
Иммиграция может иметь как положительные, так и отрицательные экономические последствия для страны, например, предоставляя дешевую рабочую силу и усиливая конкуренцию за рабочие места и ресурсы.	Economic	ru	1.0
Способность страны принимать и поддерживать иммигрантов ограничена ее возможностями в отношении жилья, образования, здравоохранения и других ресурсов.	Capacity and Resources	ru	2.0
Этические аспекты миграции включают вопросы о правах мигрантов и обязанностях принимающих стран по отношению к ним.	Morality	ru	3.0
Иммиграционная политика должна быть честной и справедливой, обеспечивающей равные возможности для всех иммигрантов.	Fairness and Equality	ru	4.0
Иммиграционные законы и политика должны соответствовать правовым и конституционным принципам, и правительство несет ответственность за их соблюдение.	Legality, Constitutionality, Jurisdiction	ru	5.0
Эффективная иммиграционная политика требует тщательного рассмотрения и учета целей, воздействия и стратегий реализации.	Policy Prescription and Evaluation	ru	6.0
Иммиграция может быть связана с преступностью и уголовными делами, включая безопасность границ и преступную деятельность, связанную с иммиграцией.	Crime and Punishment	ru	7.0
Иммиграционная политика влияет на национальную безопасность и оборону, включая потенциальные угрозы со стороны террористических групп и геополитических конфликтов.	Security and Defense	ru	8.0
Здоровье и безопасность мигрантов и принимающих сообществ должны учитываться в миграционной политике, включая такие вопросы, как борьба с болезнями и гигиена.	Health and Safety	ru	9.0
Миграция влияет на качество жизни как мигрантов, так и принимающих сообществ, влияя на социальную сплоченность, общественные услуги и культурную интеграцию.	Quality of Life	ru	10.0
Иммиграция формирует культурную самобытность стран и их народов, оказывая как положительное, так и отрицательное влияние на разнообразие и социальную сплоченность.	Cultural Identity	ru	11.0
Общественное отношение и восприятие иммиграции имеют важные политические и социальные последствия.	Public Sentiment	ru	12.0
На иммиграционную политику часто влияют политические соображения, такие как избирательная стратегия и партийная идеология.	Political	ru	13.0
Международные организации и договоры играют роль в формировании и регулировании иммиграционной политики, которая влияет на репутацию страны и мировое положение.	External Regulation and Reputation	ru	14.0
Однополые браки — это морально-этический вопрос, и отказ кому-либо в праве на брак из-за сексуальной ориентации является дискриминационным и несправедливым.	Morality	ru	3.0
Все люди, независимо от сексуальной ориентации, должны иметь право вступать в брак с теми же правами и правовой защитой, что и гетеросексуальные пары.	Fairness and Equality	ru	4.0
Несправедливо и аморально отказывать людям в праве на брак из-за сексуальной ориентации.	Morality	ru	3.0
Все люди, независимо от сексуальной ориентации, должны иметь право вступать в брак с теми же правами и правовой защитой, что и гетеросексуальные пары.	Fairness and Equality	ru	4.0
Принятие и отношение к однополым бракам со временем изменились во многих частях мира, но еще предстоит преодолеть значительные культурные и социальные барьеры.	Public Sentiment	ru	12.0
Политика и законы в отношении однополых браков оказывают значительное влияние на общество, и важно оценить их влияние и внести необходимые изменения для обеспечения справедливости и равенства.	Policy Prescription and Evaluation	ru	6.0
Легализация однополых браков имеет экономические выгоды, поскольку увеличивает туризм и создает новые рабочие места в свадебной индустрии.	Economic	ru	1.0
Хотя однополые браки могут бросить вызов традиционным представлениям о гендерных ролях и социальных нормах, некоторые считают, что они способствуют развитию более разнообразной и приемлемой культурной идентичности.	Cultural Identity	ru	11.0
Отказ однополым парам в праве на вступление в брак отрицательно сказывается на их здоровье и благополучии, поскольку они сталкиваются с дискриминацией и не имеют доступа к важным правовым и экономическим средствам защиты.	Health and Safety	ru	9.0
Дебаты об однополых браках являются важным политическим вопросом во многих странах, где политические партии и политики занимают разные позиции в зависимости от своих убеждений и взглядов избирателей.	Political	ru	13.0
Легализация однополых браков является важным шагом к равноправию ЛГБТК+ сообщества и гарантирует те же права и возможности, что и гетеросексуальные пары.	Fairness and Equality	ru	4.0
Для многих однополые браки являются моральной проблемой, некоторые говорят, что они противоречат традиционным ценностям, в то время как другие настаивают на том, что они прославляют любовь и товарищеские отношения независимо от пола.	Morality	ru	3.0
Отказ однополым парам в праве на брак является явным нарушением основных прав человека, таких как равенство и недискриминация.	Fairness and Equality	ru	4.0
Однополые браки дают парам важные преимущества для здоровья, в том числе: B. Медицинские льготы, страховое покрытие и доступ к необходимой медицинской помощи в случае болезни или неотложной помощи.	Health and Safety	ru	9.0
Чиновник, знакомый с проектом бюджета, предоставил подробности запроса на финансирование до того, как президент Байден объявил план в понедельник на условиях анонимности.	Capacity and Resources	ru	2.0
ICE будет продолжать контролировать отдельные места содержания под стражей, чтобы обеспечить благоприятные условия в сотрудничестве с ERO, OPR и другими регулирующими органами в рамках Министерства внутренней безопасности.	Capacity and Resources	ru	2.0
HSI работала с ФБР, чтобы заставить министерство юстиции предъявить обвинения двум сообщникам.	Capacity and Resources	ru	2.0
Координирует управление содержанием под стражей с 25 полевыми офисами ERO, чтобы обеспечить безопасную среду для неграждан, содержащихся под стражей ICE, посредством соблюдения требований учреждения, мониторинга на местах и ​​покупки мест содержания под стражей.	Capacity and Resources	ru	2.0
25 Полевой офис ERO содействует материально-технической и оперативной поддержке деятельности по уклонению от уплаты налогов путем разработки, внедрения и мониторинга планов и процедур, поддерживающих миссию Плана действий по уклонению от уплаты налогов по всей стране.	Capacity and Resources	ru	2.0
Эти центры используют технические знания, аналитические инструменты и опыт правоохранительных органов для разработки рекомендаций по депортации для неграждан на основе разведывательных данных.	Capacity and Resources	ru	2.0
Благодаря сбору данных, анализу и совершенствованию технологий и процессов LESA предоставляет инструменты, исследования и рекомендации для поддержки принятия решений и планирования ICE.	Capacity and Resources	ru	2.0
Работая с межведомственными и межведомственными заинтересованными сторонами, иностранными посольствами и консульствами, а также международными партнерами, подразделение разрабатывает и реализует стратегии депортации для неамериканских граждан, ожидающих депортации.	Capacity and Resources	ru	2.0
Мы поддерживаем универсальную политику в области прав человека и защиты мигрантов и беженцев и призываем к многосторонним действиям для устранения коренных причин миграции, включая изменение климата.	Capacity and Resources	ru	2.0
Некоммерческая организация, которая соответствует стандартам приемлемости для PA, штата и программы и имеет административные полномочия для управления назначенными программами и программными фондами от имени CDSS.	Capacity and Resources	ru	2.0
Если вы находитесь в Соединенных Штатах без разрешения или условно-досрочного освобождения от сотрудника иммиграционной службы, ваше незаконное пребывание начинается с даты вашего въезда в страну без разрешения или условно-досрочного освобождения.	Crime and Punishment	ru	7.0
Как правило, если вы допущены в Соединенные Штаты или задержаны сотрудником иммиграционной службы, вы получите форму I-94, запись о прибытии/попытке, с точной датой, когда вы собираетесь покинуть страну.	Crime and Punishment	ru	7.0
Если вы покидаете Соединенные Штаты после начала процесса депортации, включая добровольное выдворение, вы обязаны уведомить об этом Административное бюро иммиграционного контроля.	Crime and Punishment	ru	7.0
10-летняя линия также применяется, если вы уходите до, во время или после начала вашего исключения из DHS.	Crime and Punishment	ru	7.0
Таким образом, вы можете повторно подать заявление на получение разрешения на въезд в Соединенные Штаты, даже если вы не допущены на постоянной основе, но только в том случае, если вы физически не находились в Соединенных Штатах в течение как минимум 10 лет после вашего последнего отъезда.	Crime and Punishment	ru	7.0
В зависимости от иммиграционных льгот, на получение которых вы подаете заявление, закон может лишить вас права на участие в программе.	Crime and Punishment	ru	7.0
Вы должны написать «возвращены в Соединенные Штаты в течение от трех до десяти лет, требуемых по закону», чтобы облегчить идентификацию и избежать задержек с удалением файла.	Crime and Punishment	ru	7.0
В Законе об иммиграции и гражданстве (INA) изложены основания для неприемлемости человека.	Crime and Punishment	ru	7.0
В Техасе мало преступных нелегальных иммигрантов, потому что нелегальные иммигранты годами остаются незамеченными.	Crime and Punishment	ru	7.0
Иммигранты, в том числе испаноязычные неграждане, несколько чаще сообщают о преступлениях, чем коренные жители, согласно Национальному обзору сообщений о преступности, который предназначен для измерения готовности людей сообщать о преступлениях.	Crime and Punishment	ru	7.0
Ассимиляция – это процесс, посредством которого группа или культура меньшинства перенимает поведение, ценности, обычаи и убеждения группы большинства в принимающей стране.	Cultural Identity	ru	11.0
Термин «ассимиляция» часто используется для описания иммигрантов, переезжающих на новое место. Однако он также используется для обсуждения этнических групп.	Cultural Identity	ru	11.0
Коренные жители, иммигранты и этнические меньшинства часто меняют или скрывают аспекты своей культуры, включая язык, пищу, одежду и духовные практики, чтобы перенять ценности и социальное поведение доминирующей культуры.	Cultural Identity	ru	11.0
Важно помнить, что добровольная интеграция часто является ответом на давление со стороны более доминирующей культуры, и что адаптация является ключом к сохранению жизни и безопасности людей. Принудительная ассимиляция: это ситуация, когда меньшинство или этническая группа вынуждены подчиняться. Их культурная самобытность, язык, обычаи и традиции соответствуют доминирующей группе.	Cultural Identity	ru	11.0
Хотя это был обычный процесс среди государств, он стал спорным политическим вопросом: некоторые политики и общественность в прошлом утверждали, что европейские иммигранты ассимилировались быстрее, чем меньшинства.	Cultural Identity	ru	11.0
Сегодня и в прошлом многие белые в этой стране рассматривают иммигрантов и меньшинства как угрозу национальной культуре, опасаясь наших различий и оказывая прямое и косвенное давление, включая угрозы, на тех, кто не согласен. и насилие.	Cultural Identity	ru	11.0
Культурная ассимиляция была предназначена для ограничения самосегрегации, но в этот период иммигрантов поощряли к ассимиляции для социальной стабильности и экономического процветания.	Cultural Identity	ru	11.0
Другое исследование домохозяйств иммигрантов показало, что большее количество братьев и сестер, родившихся за границей, с большей вероятностью будут безработными, закончат школу за меньшее количество лет, заработают меньше и вступят в брак с супругами, родившимися за границей.	Cultural Identity	ru	11.0
В то время как насильственная ассимиляция является формой насилия, принуждение меньшинств к принятию чужих культурных практик в лучшем и худшем случае.	Cultural Identity	ru	11.0
Коренные народы, этнические меньшинства и иммигранты часто по-разному переживают ассимиляцию, поэтому важно тщательно обсудить и рассмотреть, как происходила эта ассимиляция и ее последствия.	Cultural Identity	ru	11.0
В индустрии гостеприимства 38% владельцев бизнеса родились за пределами США, по сравнению с 24% владельцев магазинов.	Economic	ru	1.0
Учитывая, что 85 миллионов американцев живут в округах, потерявших свой самый трудоспособный возраст в период с 2011 по 2021 год, и 160 миллионов живут в округах с сокращающимся или стабильным населением, пришло время снова начать обсуждение того, как иммиграция связана с местным и региональным экономическим развитием. .	Economic	ru	1.0
На 20 самых густонаселенных округов США приходится 36% иммигрантов, имеющих как минимум высшее образование, по сравнению с 19% всего населения страны.	Economic	ru	1.0
Государственные и местные политики, в частности, должны разработать структуру, чтобы лучше понять, почему иммигранты важны для Америки и какую ценность иммигранты приносят своим сообществам.	Economic	ru	1.0
Минимальные инвестиции в TEA увеличены до 900 000 долларов США (с 500 000 долларов США) с учетом инфляции.	Economic	ru	1.0
DHS следует графику [DHS/USCIS/ICE/CBP-001 Документы иностранца и национальная система отслеживания документов, DHS/USCIS-007 Информационная система преимуществ и DHS/USCIS-018 Иммиграционные биометрические данные и биография] и предоставляет политику конфиденциальности оценки воздействия [DHS]. Из ]. ] публикация. /USCIS/PIA-016(a) Прикладные и компьютерные информационные системы], доступно на сайте www.dhs.gov/privacy.	Economic	ru	1.0
Даже 10-процентная разница в заработной плате за год туда и обратно позволяет этим низкоквалифицированным работникам найти работу в Соединенных Штатах, а не отправляться домой. Эффективная, хорошо спланированная и хорошо реализованная программа сокращения бедности может увеличить доход в 35 раз по сравнению с тем, с чего она начиналась.	Economic	ru	1.0
Но нынешний разрыв в заработной плате и неоспоримый спрос на рабочую силу между богатыми и бедными странами означают, что любое движение людей происходит без законных прав и без поддержки работодателей.	Economic	ru	1.0
Влияние иммиграции на заработную плату отрицательно для профессий с менее образованными домашними работниками и более высоким уровнем иммигрантов. 4 Иммиграция влияет как на занятость, так и на заработную плату. Возможности для местных работников.	Economic	ru	1.0
Приток иммигрантов усилил конкуренцию за работу, что привело к сокращению возможностей трудоустройства домашних работников. Однако иммиграция мало повлияла на возможности трудоустройства. 6 Чистый эффект иммиграции на экономику США положительный. 7 Иммигранты увеличивают количество занятых в экономике, что приводит к более высокому экономическому росту и более высокой заработной плате домашних работников.	Economic	ru	1.0
Новые правила дают лицам, ищущим убежища, больше возможностей выслушивать и выносить решения в отношении лиц, ищущих убежища (дело обычно передается иммиграционным судьям), когда они появляются на южной границе США.	External Regulation and Reputation	ru	14.0
Индикатор управления миграцией (MGI) обеспечивает основу для оценки целостности национальной миграционной политики и для выявления пробелов и приоритетов для наращивания институционального потенциала и программ миграции.	External Regulation and Reputation	ru	14.0
Рассматриваются различные подпараметры каждой категории полиса, включая право на участие, условия, гарантии статуса и связанные с ними права.	External Regulation and Reputation	ru	14.0
Панель организована по пяти параметрам политики: институциональная сплоченность, снижение затрат на миграцию, защита прав мигрантов и семей, содействие интеграции и реинтеграции и усиление воздействия миграции на развитие.	External Regulation and Reputation	ru	14.0
Иммиграционные правила содержатся в Разделе 8 Свода федеральных правил (Иностранцы и граждане), который эквивалентен Разделу 8 Кодекса США (Иностранцы и граждане).	External Regulation and Reputation	ru	14.0
Потребности и проблемы продвижения гендерного равенства и справедливости очевидны во всем мире.	Fairness and Equality	ru	4.0
Он добился выдающегося лидерства и способностей на самом высоком политическом уровне, в том числе в правительстве США, Белом доме, Государственном департаменте и миссии США при Организации Объединенных Наций, Агентстве международного развития (USAID) и Министерстве здравоохранения. . Человеческие ресурсы. и социальные службы (HHS).	Fairness and Equality	ru	4.0
Поскольку администрация Трампа продолжает атаковать гендерные вопросы, особенно сексуальное и репродуктивное здоровье и права ЛГБТКИ+, перед администрацией Байдена стоит стратегический императив по продвижению гендерного равенства и справедливости, необходимых для достижения целей глобального здравоохранения и развития США. Это показывает, что экономическое процветание и национальная безопасность могут быть достигнуты.	Fairness and Equality	ru	4.0
В то время как в других администрациях есть офисы, посвященные женщинам и девочкам, нынешний Совет по гендерной политике Белого дома является первым политическим советом при президенте, который сосредоточил внимание на гендерном равенстве и гендерном равенстве, включая женщин и девочек, но он более инклюзивен и широк. . Гендерная повестка, включая вопросы ЛГБТКИ+.	Fairness and Equality	ru	4.0
Белый дом, вероятно, будет нести ответственность за организацию и координацию межведомственных процессов, которые должны регулировать напряженность и конкуренцию между агентствами и учреждениями и требуют постоянной личной поддержки на высоком уровне со стороны администрации.	Fairness and Equality	ru	4.0
По данным Торговой палаты США, разнообразие, справедливость и инклюзивность (часто называемая DEI) представляет собой основу социального развития, которую можно применять в бизнес-среде.	Fairness and Equality	ru	4.0
Пандемия усугубила проблемы со здоровьем и экономические проблемы, с которыми сталкиваются мигранты, и удовлетворение потребностей мигрантов становится все более важным по мере роста активности мигрантов вдоль американо-мексиканской границы.	Health and Safety	ru	9.0
Хотя многие граждане не старшего возраста живут в домохозяйствах с работниками, работающими полный рабочий день, у них меньше доступа к частному страхованию, поскольку они с большей вероятностью будут работать на низкооплачиваемых работах и ​​в отраслях, где работодатели с меньшей вероятностью будут предлагать пенсии. - Спонсорский отчет.	Health and Safety	ru	9.0
B. Некоторые иммигранты, такие как обладатели временного защищенного статуса, являются законными, но не имеют права на получение Medicaid или CHIP, в зависимости от того, как долго они находятся в стране.	Health and Safety	ru	9.0
Лица со статусом DACA не считаются юридически доступными для получения права на медицинское страхование и не имеют права на варианты покрытия в соответствии с правилами, изданными Центрами услуг Medicare и Medicaid (CMS).	Health and Safety	ru	9.0
Даже если они имеют право на страховое покрытие, многие семьи иммигрантов остаются незастрахованными из-за множества препятствий, с которыми они сталкиваются при регистрации, включая страх, путаницу в отношении процесса получения права на участие, трудности с процессом регистрации, а также проблемы с языком и грамотностью.	Health and Safety	ru	9.0
Исследования показывают, что изменения иммиграционной политики администрации Трампа заставляют семьи иммигрантов стремиться зарегистрировать себя и/или своих детей в программах Medicaid и CHIP, несмотря на то, что они имеют на это право.	Health and Safety	ru	9.0
Дженнифер Чакон: «Штаты приняли законы, призванные предотвратить пересечение границ штатов всеми группами, включая лиц с судимостью, получателей государственных грантов, рабов и свободных чернокожих».	Legality, Constitutionality, Jurisdiction	ru	5.0
«Аманда Фрост — отличное дополнение к нашему преподавательскому составу благодаря своим знаниям и опыту в области иммиграционного и конституционного права», — сказала декан Риса Голубофф.	Legality, Constitutionality, Jurisdiction	ru	5.0
«Идея этой книги пришла ко мне, когда я просмотрел истории людей, потерявших гражданство на протяжении всей американской истории, и понял, что это гораздо более масштабное явление, чем я думал раньше», — сказал Фрост.	Legality, Constitutionality, Jurisdiction	ru	5.0
Увидев систему уголовного правосудия в действии, он захотел «стать ее частью и представлять людей, которые не хотят, чтобы их голоса были услышаны». После колледжа она год работала помощником юриста в сфере гражданских прав. Он подал документы на юридическое образование в институт и школу, которые окончил.	Legality, Constitutionality, Jurisdiction	ru	5.0
«Я нахожу вопросы [иммиграции] интересными на всех фронтах, от политических вопросов до юридических интерпретаций и сложных конституционных вопросов об отношениях между тремя ветвями власти», — сказал он.	Legality, Constitutionality, Jurisdiction	ru	5.0
Власти штатов уполномочены обеспечивать соблюдение федеральных иммиграционных законов путем ареста иммигрантов, ранее осужденных за уголовные преступления.	Legality, Constitutionality, Jurisdiction	ru	5.0
Вы смотрите на офицера и говорите: «Разве ты не можешь посмотреть на меня и сказать, что я в порядке?» ты можешь подумать. К сожалению, это не так. Достаточно	Morality	ru	3.0
Следовательно, если вы курите медицинскую марихуану или рекреационную марихуану, вас могут считать морально развращенным, даже если это разрешено законом в вашем штате, и вы никогда не подвергались аресту или осуждению за контролируемое вещество.	Morality	ru	3.0
Моральный облик и законный постоянный житель (LPR). Если вы являетесь законным постоянным жителем (LPR) и хотите подать заявление на получение гражданства/гражданства США, вы должны продемонстрировать приемлемые моральные качества должностным лицам USCIS во время вашего законного постоянного проживания.	Morality	ru	3.0
Этика и процедура в иммиграционных судах. Когда человек подлежит депортации или высылке USCIS, он должен продемонстрировать хорошие моральные качества.	Morality	ru	3.0
В типичном примере, когда кто-то подает заявление на получение гражданства США из-за серьезной травмы или эмоционального насилия, доказательства значительного успеха во время его пребывания в Соединенных Штатах могут подорвать все дело этого человека.	Morality	ru	3.0
Если они не подают заявление в течение первого года, они теряют возможность получения убежища.	Other	ru	15.0
Более 200 000 афганцев, украинцев, венесуэльцев, никарагуанцев, кубинцев и гаитян прошли более формальный гуманитарный испытательный срок.	Other	ru	15.0
Представители Белого дома и Министерства внутренней безопасности начали обсуждать иммиграционный кризис и дальнейшие ограничения на въезд мигрантов в Соединенные Штаты между границей США и Мексики.	Other	ru	15.0
«Что касается управления, мы учитываем все юридические соображения, прежде чем приступить к политике, и предлагаемые новые правила отражают эти соображения», — говорится в заявлении правительственного чиновника.	Other	ru	15.0
Предложение по реформированию иммиграционной системы застопорилось, поскольку власти опасаются рекордного количества мигрантов, прибывающих на южную границу США, сообщили источники CNN.	Other	ru	15.0
«Это не наш главный приоритет, это не наш второй приоритет», — ранее заявил журналистам представитель администрации, подчеркнув усилия по открытию легального доступа к использованию приложений в Соединенных Штатах и ​​отметив, что голосование по реформе основано на законопроекте. с Конгрессом. .	Other	ru	15.0
В рамках иммиграционного медицинского осмотра заявитель, гражданский хирург и все другие медицинские работники, оценивающие заявителя, должны подписать форму и подтвердить, что то, что они говорят, соответствует действительности.	Policy Prescription and Evaluation	ru	6.0
Если беженцу нужен только тест на прививку, необходимо заполнить форму: информация о заявлении, тест на вакцинацию и сертификат.	Policy Prescription and Evaluation	ru	6.0
Служба гражданства и иммиграции США (USCIS) принимает заявителей с определенной физической или умственной отсталостью или инвалидностью, связанной с развитием, когда другой заявитель с такой же инвалидностью или расстройством имеет право на освобождение от инвалидности.	Policy Prescription and Evaluation	ru	6.0
Отказ от инвалидности можно получить, только заполнив форму N-648, которая требует доказательства того, что физическая или умственная неполноценность или умственная отсталость заявителя не позволяет заявителю соответствовать требованиям английского языка или гражданства, или тому и другому. Приемлемое жилье.	Policy Prescription and Evaluation	ru	6.0
Переводчики, предоставляющие услуги по переводу медицинских осмотров с помощью телемедицины, не обязаны заполнять форму N-648 «Сертификация переводчика».	Policy Prescription and Evaluation	ru	6.0
В течение многих лет Конгрессу не удавалось договориться о всеобъемлющей иммиграционной реформе, фактически перекладывая некоторые ключевые политические решения на исполнительную и судебную ветви власти и разжигая дебаты в палатах штатов и местных органов власти.	Political	ru	13.0
Действия Байдена по изменению политики эпохи Трампа включают ослабление иммиграционных ограничений в США, отмену запрета на поездки, отмену моратория на обработку грин-карт и прекращение строительства стены вдоль границы США и Мексики.	Political	ru	13.0
Между тем исторический приток мигрантов к южной границе угрожает еще больше подорвать усилия Байдена: в мае 2022 года количество арестов на границе достигло почти 240 000 человек, что является 20-летним максимумом после спада, связанного с пандемией.	Political	ru	13.0
На саммите стран Америки 2022 года 23 лидера стран Западного полушария договорились о соглашении о миграции, направленном на увеличение помощи беженцам, улучшение управления границами и улучшение координации реагирования на чрезвычайные ситуации.	Political	ru	13.0
Байден и президент Мексики Андрес Мануэль Лопес Обрадор также посетили Южную Америку. Предлагается совместный план инфраструктуры безопасности границ для продления временных рабочих виз и увеличения инвестиций в пограничный надзор.	Political	ru	13.0
«До 1920-х годов общая тенденция дебатов об иммиграции была негативной, но в течение одного поколения — с 1945 по 1965 год — она стала очень позитивной», — сказал профессор экономики и историк экономики Рон Абрамицки. Стэнфордский университет сотрудничает с исследователями ИИ для публикации новой работы.	Public Sentiment	ru	12.0
Помимо Карда и Абрамицки, в команду входит компьютерщик из Стэнфорда Серена Чанг. Крис Бейкер, экономист из Стэнфорда. Джулия Мендельсон — специалист по данным из Мичиганского университета. Дэн Джурафски — профессор лингвистики и компьютерных наук в Стэнфорде. ; Профессор; Роб Фойгт, доцент кафедры лингвистики Северо-Западного университета.	Public Sentiment	ru	12.0
Чтобы построить модель машинного обучения, которая может точно идентифицировать голоса иммигрантов, команда вручную оценила образцы речи исследователей, чтобы определить, были ли они положительными, отрицательными или нейтральными, и как они представляли иммигрантов.	Public Sentiment	ru	12.0
Проиммигрантский тон в недавнем политическом дискурсе отражает все более позитивное отношение по всей стране.	Public Sentiment	ru	12.0
Как сообщалось в прошлом месяце, нелегальная иммиграция является второй по величине публичной проблемой с точки зрения расовой принадлежности среди 14 проблем, рассмотренных в этом году.	Public Sentiment	ru	12.0
«Нам не нужно оказывать давление на президента Байдена по поводу запрета на предоставление убежища, мы мобилизуем людей, чтобы поднять свой голос против этой ужасной несправедливости», — сказал Билал Асьяр, исполняющий обязанности директора кампании коалиции #WelcomeWithDignity. Иммиграционное право и правовые институты.	Public Sentiment	ru	12.0
Всемирная организация здравоохранения определяет качество жизни как субъективную оценку своего восприятия реальности своих целей через призму своей культуры и системы ценностей.	Quality of Life	ru	10.0
Это обойдется нашей системе предоставления убежища в миллионы долларов на административные расходы и юридическую поддержку тех, кто злоупотребляет системой с необоснованными, ложными или злонамеренными заявлениями — см. наш брифинг о растущем бремени и затратах на злоупотребление системой предоставления убежища.	Quality of Life	ru	10.0
Заторы усугубляются: Лондон в настоящее время является самым загруженным городом в мире, а растущие заторы привели к безумному решению правительства перейти на «умные автомагистрали», как обнаружила компания Enrix, занимающаяся данными о дорожном движении. Снизьте безопасность вождения и поставьте семьи под угрозу, устраните жесткое плечо.	Quality of Life	ru	10.0
Не говоря уже о кошмаре общественной безопасности, порожденном невозможностью отследить тысячи нелегальных иммигрантов, въезжающих в страну на лодках, самолетах и ​​грузовиках, и тенденцией преднамеренно уничтожать удостоверения личности тех, кто въезжает в страну. .	Quality of Life	ru	10.0
Законы, дискриминирующие неграждан, а также программы и политика, которые не учитывают их особые потребности и уязвимые места, часто лишают семьи и их семьи доступа к необходимым услугам.	Quality of Life	ru	10.0
Возможность женщины мигрировать может быть ограничена личными и семейными факторами, такими как возраст, семейный стаж, расовая/этническая принадлежность, семейное положение и наличие или отсутствие детей.	Quality of Life	ru	10.0
Иммигрантов дегуманизируют, осуждают, произвольно задерживают и иногда разлучают со своими детьми из-за их этнических убеждений.	Quality of Life	ru	10.0
Барьеры и стены возникают из-за веры в то, что блокирование безопасных и упорядоченных путей передвижения и преднамеренное усиление их заставит людей меньше хотеть покидать свои земли.	Quality of Life	ru	10.0
Иммигранты должны продемонстрировать, что они опасаются преследований по возвращении.	Quality of Life	ru	10.0
Число было определено путем опроса людей по всей стране по ряду тем, включая доступность жилья, стоимость жизни, время в пути, загрязнение окружающей среды, преступность, здоровье, доступность, развлечения и занятость.	Quality of Life	ru	10.0
После 11 сентября Министерство внутренней безопасности (DHS) и федеральное правительство вместе со своими многочисленными партнерами в государственном и частном секторах, а также в национальном и глобальном сообществах работали над радикальным восстановлением и улучшением того, что было новым. Родина. Безопасность — это физическая безопасность. Динамические угрозы повышают вашу способность смягчать, реагировать и восстанавливаться после всех типов атак и аварий.	Security and Defense	ru	8.0
Служба гражданства и иммиграции США (USCIS) обновила свои разрешения на работу, включив в них машиночитаемое поле, которое позволяет офицерам пограничного контроля более эффективно идентифицировать лиц, допущенных к иммиграции и ранее проверенных сотрудниками USCIS.	Security and Defense	ru	8.0
МЫ. Береговая охрана повышает способность ВМФ реагировать на угрозы за счет создания значительных сил США, включая боевые силы, силы по борьбе с терроризмом, а также присутствие и развертывание оружия массового уничтожения. Способность быстро реагировать на команды морской и портовой безопасности. Угрозы инсайдерской навигации и последующие ответы.	Security and Defense	ru	8.0
Обнаружение радиации: CBP внедрила радиационные экраны и другие технологии обнаружения радиации в портах, сухопутных границах и почтовых учреждениях по всему миру.	Security and Defense	ru	8.0
После 11 сентября Министерство внутренней безопасности (DHS) и федеральное правительство вместе со своими многочисленными партнерами в государственном и частном секторах, а также в национальном и глобальном сообществах работали над радикальным восстановлением и улучшением того, что было новым. Родина. Безопасность — это физическая безопасность. Динамические угрозы повышают вашу способность смягчать, реагировать и восстанавливаться после всех типов атак и аварий.	Security and Defense	ru	8.0
Современные читатели могут оценить свадьбы «мужчины и женщины», устроенные мужскими и женскими клубами в начале 20-го века для сбора денег для Liberty Bonds.	Capacity and Resources	ru	2.0
Исследуйте культурные аспекты гомосексуализма, такие как Иисус, его воображаемая свадьба и история Марка Твена — как он женился на Кейт Уилсон, чью работу Нэнси Джексон не осмелилась опубликовать.	Capacity and Resources	ru	2.0
После частного слушания: судья по делу об убийстве в Чикаго в 1923 году постановил, что «то, что Томпсон был мужчиной, не повлияло на ее статус мужа, что было вопросом толкования закона». Томпсону не разрешили давать показания. , потому что тогда женщина может свидетельствовать в пользу своего мужа».	Capacity and Resources	ru	2.0
Однополые пары — такие как родственные пары, смешанные пары, сожительствующие пары и полигамия — могут быть или не быть законными в глазах государства, но они существуют.	Capacity and Resources	ru	2.0
Как спрашивает Клиффс: «Должны ли они пониматься как геи или все же вписываться в трансгендерную историю, определяемую историей геев и лесбиянок?	Capacity and Resources	ru	2.0
ЛГБТК+ люди, которые уже состоят в браке, говорят, что запрет все еще позволяет им вступать в брак	Crime and Punishment	ru	7.0
ЛГБТК+ люди, желающие вступить в брак в 32 штатах, не имеющих равных прав на брак, должны вступить в брак за пределами штата, и их штат должен признать их союз.	Crime and Punishment	ru	7.0
Что означает законопроект для тех, кто вступает в брак в штатах, где браки ЛГБТК+ запрещены?	Crime and Punishment	ru	7.0
Если Верховный суд отменит равенство в браке, есть ли способ восстановить равенство в браке по всей стране?	Crime and Punishment	ru	7.0
Кларенс Томас, один из судей большинства, отменивших решение Роу, написал мнение, в котором утверждалось, что суд должен «повторно посетить» Обергефелл, назвав это одним из ошибочных решений суда. Ряд остается на месте в течение очень короткого времени, прежде чем двигаться дальше.	Crime and Punishment	ru	7.0
Однополые пары выиграли битву за равенство в браке и пользуются многими, если не всеми, супружескими льготами, предусмотренными федеральным законодательством и законодательством штата.	Economic	ru	1.0
В некоторых штатах и ​​округе Колумбия супружеские пары могут владеть имуществом, таким как их дома и банковские счета, что ограничивает то, как кредиторы могут налагать арест на определенные активы, имеющие право собственности.	Economic	ru	1.0
Для не состоящих в браке партнеров по жизни, получающих такое же вознаграждение работника (если работодатель также выплачивает вознаграждение спутнику жизни), стоимость пособия спутника жизни обычно равна налогооблагаемому доходу работника по федеральным подоходным налогам.	Economic	ru	1.0
Теперь, когда однополые браки признаны, однополые пары могут наслаждаться утешением, зная, что они по закону на их стороне, когда дело доходит до принятия решений в отношении больных супругов и контроля над активами их супругов. Смерть за отсутствием других договоренностей.	Economic	ru	1.0
Экономическое влияние однополых браков положительно влияет на экономику штата и местную экономику, а также на свадебную индустрию.	Economic	ru	1.0
Международные организации, в том числе ООН, приняли резолюции в поддержку прав ЛГБТК+, но правозащитные группы говорят, что их правоприменительные полномочия ограничены.	External Regulation and Reputation	ru	14.0
«Ни один здравомыслящий дипломат не захочет посетить страну, которая не готова к однополым бракам», — сказал Дорф.	External Regulation and Reputation	ru	14.0
По мере роста общественной поддержки однополых браков продолжаются дебаты между отдельными лицами и организациями, поддерживающими юридическое равенство, и теми, кто выступает против равенства браков на основе религии.	External Regulation and Reputation	ru	14.0
В конце 20 века либерализация отношения к гомосексуализму и законов, регулирующих гомосексуальное поведение, особенно в Западной Европе и США, привела к повышенному академическому и общественному интересу к этой теме.	Cultural Identity	ru	11.0
В начале 2000-х годов многие страны и местные юрисдикции легализовали однополые браки. В других юрисдикциях были предприняты конституционные шаги для запрета однополых браков или приняты законы, запрещающие признание таких браков, заключенных где-либо еще.	Cultural Identity	ru	11.0
Тот факт, что разные группы по-разному анализируют одно и то же поведение, демонстрирует его важность как социальной проблемы в начале двадцать первого века. Это также показывает, что существует культурное разнообразие внутри стран и между ними.	Cultural Identity	ru	11.0
Наиболее распространенной формой документа является гражданский брак. Браки Моргана, в которых титул и имущество не переходят к детям. Брак по обмену, при котором один брат из одной семьи женится на другом брате. и брак на основе полигамии (супружеского) или кланового брака. полигамия (жена).	Cultural Identity	ru	11.0
Религиозные и светские ожидания от брака и секса\nСо временем история и традиционная культура, написанные Бахофеном и Морганом, среди прочих, постепенно пали жертвой гомогенизации, навязанной колониализмом.	Cultural Identity	ru	11.0
Международные организации, в том числе ООН, приняли резолюции в поддержку прав ЛГБТК+, но правозащитные группы говорят, что их правоприменительные полномочия ограничены.	Fairness and Equality	ru	4.0
Тем временем в российской полуавтономной республике Чечня десятки мужчин, подозреваемых в гомосексуализме, были арестованы, подвергнуты пыткам и убиты с 2017 года в ходе двух отдельных правительственных операций.	Fairness and Equality	ru	4.0
Законодатели Таиланда и Вьетнама рассматривают законопроекты, легализующие однополые браки или сожительство.	Fairness and Equality	ru	4.0
По данным ILGA, поддержка легализации однополых браков также самая низкая в странах Карибского бассейна: 16 процентов на Ямайке и 23 процента в Доминиканской Республике.	Fairness and Equality	ru	4.0
Правовые отношения супругов, родителей и детей также имели тенденцию к перекрытию в группах, где однополые браки были весьма проблематичными.	Health and Safety	ru	9.0
Вопреки либеральной модели брака, сторонники законных однополых браков часто считают, что совершенные союзы, включающие сексуальную близость, ценны, потому что они объединяют людей уникальными и уникальными способами.	Health and Safety	ru	9.0
В некоторых других странах есть исламские конституции, которые часто интерпретируются как запрещающие однополым парам вступать в брак.	Legality, Constitutionality, Jurisdiction	ru	5.0
В Соединенных Штатах однополые браки стали официальным требованием движения за права геев после Второго национального марша за права геев в Вашингтоне в 1987 году.	Legality, Constitutionality, Jurisdiction	ru	5.0
В других странах принятые конституции содержат формулировку о том, что брак заключается между мужчиной и женщиной, в то время как нет формулировок, запрещающих однополые браки, особенно в старых конституциях.	Legality, Constitutionality, Jurisdiction	ru	5.0
Они также заявили, что замена однополых браков отдельными законами, такими как сожительство, является неприемлемой и дискриминационной.	Legality, Constitutionality, Jurisdiction	ru	5.0
Несмотря на то, что они относительно обособлены, некоторые организации полностью признают однополые союзы.	Legality, Constitutionality, Jurisdiction	ru	5.0
Хотя однополые браки регулируются законом, религией и традициями в большинстве стран мира, правовые и социальные реакции варьируются от прославления, с одной стороны, до криминализации, с другой.	Morality	ru	3.0
В конце 20-го и начале 21-го веков взгляды одной или нескольких мировых религий (буддизм, индуизм, иудаизм, ислам и христианство) и их соответствующие практики гражданского права часто цитировались в национальных дебатах об однополых браках.	Morality	ru	3.0
Даже в Иране, где сильные мусульманские религиозные убеждения криминализируют гомосексуальность, и даже в Дании, где итоги конференции евангелическо-лютеранских епископов (представителей государственной религии) прокладывают путь к первому уровню национального признания. Однополые отношения через зарегистрированные партнерства.	Morality	ru	3.0
В других случаях принцип культурного равенства, продвигаемый господствующей религией, не перешел в политическую сферу, даже если он вызвал эмоциональные дебаты среди граждан: например, в Бельгии и Испании законность однополых браков выходит на первый план. играть? Религиозная организация, Римско-католическая церковь.	Morality	ru	3.0
Но дело Верховного суда Roe v. Решение Уэйда вызвало новые опасения, что высший суд страны рассмотрит другие права, связанные с равенством брака. .	Other	ru	15.0
Слова «никаких планов на следующие несколько лет» представляли собой удивительное личное развитие для давнего жителя Вашингтона, учитывая настойчивость Байдена, когда сенатор проголосовал за то, чтобы заблокировать федеральное правительство от признания однополых браков, на чем он ранее только настаивал. Состояние мужчин и женщин внутри.	Other	ru	15.0
Насилие и ненависть по-прежнему есть. Книги с темами и персонажами ЛГБТК о транс-правах, транс-спортсменах, гендерно-утверждающем здравоохранении и школах для транс-молодежи.	Policy Prescription and Evaluation	ru	6.0
Правые оппортунистические политики получают власть, вселяя необоснованный страх в маргинализированные сообщества, которые неправильно понимают эти проблемы, а затем защищают себя от своих целей.	Policy Prescription and Evaluation	ru	6.0
"Саша Айзенберг, автор книги «Помолвка: Америка на четверть такая же», сказала: «Как кандидат в президенты и вице-президент Сената, он всегда настороженно относился к проблемам ЛГБТ и боялся занимать любую позицию, которую его оппоненты могли бы использовать, чтобы изобразить его как человека левый"". - Сексуальные браки во время Столетней войны, сообщает CNN."	Policy Prescription and Evaluation	ru	6.0
Джудит Карсон-Виндзор, жена борца за права геев Эдди Виндзора. Мэтью Хейнс, совладелец Club Q, ЛГБТ-клуба в Колорадо-Спрингс, был убит в результате массовой стрельбы в прошлом месяце. 5? Выжившие в Shooting Club Q Джеймс Слоа и Майкл Андерсон; Несколько истцов в знаменательном деле о гражданских правах Obergefell v. Ходжеса, который в 2015 году постановил, что однополые пары могут вступать в брак по всей стране.	Policy Prescription and Evaluation	ru	6.0
Палата представителей в четверг приняла закон, защищающий однополые и межрасовые браки. Это последний шаг перед тем, как законопроект поступит на подпись президенту Джо Байдену и станет законом.	Policy Prescription and Evaluation	ru	6.0
Президент Джо Байден подписал во вторник исторические новые федеральные меры защиты однополых и смешанных пар, ограничив личные и национальные разработки по вопросу, который стал более приемлемым за последнее десятилетие.	Political	ru	13.0
Байден подписал Закон о доступном медицинском обслуживании перед тысячами гостей на Южной лужайке, что, по словам Белого дома, отражает важность момента.	Political	ru	13.0
Хотя общественное мнение об однополых браках менялось с годами, маловероятно, что такой закон будет принят в Вашингтоне: согласно некоммерческому опросу, 68 процентов американцев поддерживают однополые браки одного пола в 2021 году по сравнению с 2014. Их было 14. Процент публичной религии увеличился в прошлом году.	Political	ru	13.0
Слова «никаких планов на следующие несколько лет» представляли собой удивительное личное развитие для давнего жителя Вашингтона, учитывая настойчивость Байдена, когда сенатор проголосовал за то, чтобы заблокировать федеральное правительство от признания однополых браков, на чем он ранее только настаивал. Состояние мужчин и женщин внутри.	Political	ru	13.0
«Видите ли, вчера в Палате представителей была очень хорошая двухпартийная поддержка, и я надеюсь, вы увидите ее в Сенате», — сказал он.	Political	ru	13.0
Около половины (51%) людей с образованием ниже среднего говорят, что однополые браки очень хороши (26%) или достаточно хороши (25%) для общества, а 45% (20%) считают, что это не так. Очень плохо (24%).	Public Sentiment	ru	12.0
В то время как предвзятые различия разительны независимо от возраста и уровня образования американцев, эти различия более скромны среди молодых людей, чем среди пожилых людей.	Public Sentiment	ru	12.0
Молодые республиканцы выразили более позитивное отношение к однополым бракам, чем пожилые республиканцы, в то время как разница в возрасте была меньше среди демократов.	Public Sentiment	ru	12.0
Разрыв в образовании у демократов немного больше, чем у республиканцев.	Public Sentiment	ru	12.0
Даже высокопоставленные демократы, такие как бывший президент Барак Обама, не хотели делиться своей поддержкой однополых браков — Обама в конечном итоге стал первым президентом, сделавшим это.	Public Sentiment	ru	12.0
Хотя за последние 15 лет поддержка однополых браков выросла из поколения в поколение, разница в возрасте остается большой.	Quality of Life	ru	10.0
Например, 45 % взрослых представителей поколения «молчаливых» (1928–1945 г.р.) допускают однополые браки, а 74 % миллениалов (1981–1996 г.	Quality of Life	ru	10.0
Опрос Gallup 2017 года показал, что каждый десятый ЛГБТ-американец (10,2%) женился на однополом партнере за несколько месяцев до вынесения решения Верховного суда (7,9%).	Quality of Life	ru	10.0
Новый опрос, проведенный в преддверии октябрьских промежуточных выборов, показал, что Верховный суд в деле Roe v. После того, как Уэйд отменил свое решение, он поднял некоторые вопросы о том, разрешены ли однополые браки в стране. Законы об абортах возвращаются в штаты.	Quality of Life	ru	10.0
Исследовательский центр Pew Research Center опросил общественность о правовом статусе однополых браков.	Quality of Life	ru	10.0
Он требует от штатов поддерживать действительность разрешений на брак за пределами штата, в том числе для однополых и многорасовых союзов.	Security and Defense	ru	8.0
«Погоня за счастьем — это возможность любить кого угодно», — сказала она.	Security and Defense	ru	8.0
В нем разъясняется, что религиозные институты не навязывают однополые браки и что правительства не могут заставить их защищать полигамию.	Security and Defense	ru	8.0
Палата представителей во вторник приняла закон о легализации однополых браков по всей стране и усилении других мер защиты равенства в браке, что является прямым ответом на недавнее постановление Верховного суда, которое давно лишило штаты закона об абортах.	Security and Defense	ru	8.0
С одной стороны, цель брака — обеспечить беспрепятственное воспроизводство и воспитание детей.	Quality of Life	ru	10.0
