sentence	label_name	Language	label_ID
同性婚姻具有积极的经济影响，例如B. 增加旅游业和结婚证收入以及与婚礼相关的开支。	Economic	zh-CN	1.0
同性婚姻的反对者认为它会带来负面的经济后果，例如B.传统家庭结构的弱化和社会不稳定的结果。	Economic	zh-CN	1.0
同性婚姻合法化将帮助同性伴侣获得与异性伴侣相同的资源和福利，例如B. 住院权和继承权。	Capacity and Resources	zh-CN	2.0
一些同性婚姻的反对者认为，这会削弱政府机关和机构承认和承认同性婚姻的能力。	Capacity and Resources	zh-CN	2.0
同性婚姻的支持者认为这是基本人权，否认同性伴侣结婚的权利在道德上是错误的。	Morality	zh-CN	3.0
同性婚姻的反对者经常将他们的论点建立在宗教或道德的基础上，认为婚姻应该只存在于一男一女之间。	Morality	zh-CN	3.0
同性婚姻合法化通常被认为是公平和平等的问题，因为它赋予同性伴侣与异性伴侣相同的法律承认和利益。	Fairness and Equality	zh-CN	4.0
同性婚姻的反对者认为这不是平等，因为允许同性伴侣建立登记的民事伴侣关系或同居关系，这赋予他们许多与已婚夫妇相同的合法权利。	Fairness and Equality	zh-CN	4.0
同性婚姻的法律地位因司法管辖区而异，一些国家和州将其合法化，而另一些则没有。这引发了关于各州权利和联邦政府在定义婚姻中的作用等问题的辩论。	Legality, Constitutionality, Jurisdiction	zh-CN	5.0
同性婚姻的反对者经常争辩说，应该由各州来决定是否将其合法化，而支持者则经常争辩说这是联邦宪法权利的问题。	Legality, Constitutionality, Jurisdiction	zh-CN	5.0
同性婚姻的支持者认为，将同性婚姻合法化是朝着更大的平等和包容迈出的积极政治步骤。	Policy Prescription and Evaluation	zh-CN	6.0
同性婚姻的反对者认为，它具有负面的社会和文化后果，并且不能为同性伴侣面临的问题提供可行的政治解决方案。	Policy Prescription and Evaluation	zh-CN	6.0
同性婚姻合法化没有内在的刑事或刑事影响。	Crime and Punishment	zh-CN	7.0
然而，同性婚姻的反对者经常争辩说，这会导致传统家庭价值观和道德标准的崩溃，他们说这会产生负面的社会后果。	Crime and Punishment	zh-CN	7.0
同性婚姻的合法化没有内在的安全或安全影响。	Security and Defense	zh-CN	8.0
然而，一些同性婚姻的反对者认为它破坏了传统的家庭结构，他们说这对于维持强大的社会价值观和国防至关重要。	Security and Defense	zh-CN	8.0
同性婚姻合法化使同性伴侣获得重要的法律和医疗福利，如健康保险和医院探视权，从而对健康和安全产生积极影响。	Health and Safety	zh-CN	9.0
同性婚姻的反对者认为它会导致负面的健康结果，例如：	Health and Safety	zh-CN	9.0
同性婚姻合法化将对同性伴侣的生活质量产生积极影响，使他们获得更大的法律认可并获得重要的利益和资源。	Quality of Life	zh-CN	10.0
同性婚姻的反对者经常争辩说，它会破坏传统的家庭结构和价值观，从而对个人和家庭的生活质量产生负面影响。	Quality of Life	zh-CN	10.0
同性婚姻可以被视为对 LGBTQ+ 权利和接受度的文化态度转变的反映。	Cultural Identity	zh-CN	11.0
同性婚姻的反对者经常围绕保护传统文化价值观和规范展开争论。	Cultural Identity	zh-CN	11.0
近年来，同性婚姻的舆论发生了巨大变化，越来越多的人支持法律承认同性关系。	Public Sentiment	zh-CN	12.0
然而，一些同性婚姻的反对者认为，公众舆论不应左右政策决定，婚姻应被定义为一男一女之间的婚姻。	Public Sentiment	zh-CN	12.0
同性婚姻是一个高度政治化的问题，不同的政党和利益集团在这个问题上持有不同的立场。	Political	zh-CN	13.0
同性婚姻合法化在选举期间经常成为一个政治问题，候选人通过他们的平台发表评论。	Political	zh-CN	13.0
同性婚姻的法律地位会影响一个国家的国际地位，特别是与其在人权和 LGBTQ+ 问题上的立场有关。	External Regulation and Reputation	zh-CN	14.0
一些同性婚姻的反对者认为，这会损害一个国家的形象以及与其他国家的关系。	External Regulation and Reputation	zh-CN	14.0
同性婚姻与收养和儿童监护、歧视和仇恨犯罪以及健康不平等等许多其他问题交织在一起。	Other	zh-CN	15.0
关于同性婚姻的争论是复杂和多方面的，而且往往包含各种利益集团和观点。	Other	zh-CN	15.0
移民对经济既有积极影响也有消极影响，移民通过工作和消费为经济做出贡献，但也消耗公共资源。	Economic	zh-CN	1.0
一些人认为移民对于经济发展是必要的，特别是在劳动力稀缺的行业，而另一些人则认为这会导致本地出生的工人失业。	Economic	zh-CN	1.0
移民给医疗、教育和住房等公共资源带来压力，尤其是在移民人口较多的地区。	Capacity and Resources	zh-CN	2.0
然而，一些人认为，移民也带来了有益于社会并有助于这些资源增长的技能和才能。	Capacity and Resources	zh-CN	2.0
移民的道德是一个有争议的问题，一些人认为为有需要的人提供保护和机会是道德上的当务之急，而另一些人则认为允许无证移民留在该国是不道德的。	Morality	zh-CN	3.0
围绕移民的辩论通常围绕公平和平等问题展开，一些人认为将移民的需求优先于本土出生的公民是不公平的，而另一些人则认为移民无论国籍如何都应享有平等机会。	Fairness and Equality	zh-CN	4.0
移民合法性是一个复杂的问题，不同的法律和法规管理不同类型的移民和签证。	Legality, Constitutionality, Jurisdiction	zh-CN	5.0
一些人认为移民政策违宪或不公正，而另一些人则认为执法和保护国家安全很重要。	Legality, Constitutionality, Jurisdiction	zh-CN	5.0
不同移民政策和计划的有效性是一个持续的争论，不同的利益相关者提出不同的解决方案来应对移民挑战和机遇。	Policy Prescription and Evaluation	zh-CN	6.0
评估移民政策和计划对于确保其有效和公平至关重要。	Policy Prescription and Evaluation	zh-CN	6.0
移民与犯罪之间的关系是一个有争议的问题，一些人认为移民更容易犯罪并对公共安全构成威胁，而另一些人则认为移民比本土出生的公民犯罪的可能性更小。	Crime and Punishment	zh-CN	7.0
移民对国家安全和国防有影响，特别是筛选和筛选移民以及防止潜在威胁入境。	Security and Defense	zh-CN	8.0
然而，一些人认为，过度限制移民政策会损害与其他国家的关系，并限制合作和创新的机会。	Security and Defense	zh-CN	8.0
移民对公共健康和安全有影响，特别是在疾病传播和获得医疗保健方面。	Health and Safety	zh-CN	9.0
然而，一些人认为，提供医疗保健和社会服务可以改善整体公共卫生结果并减轻紧急服务的压力。	Health and Safety	zh-CN	9.0
移民对移民和本土出生的公民的生活质量既有积极影响，也有消极影响，这取决于经济条件、社会融合和文化认同等因素。	Quality of Life	zh-CN	10.0
一些人认为移民促进了多样性和文化交流，而另一些人则认为它会导致社会和经济分裂。	Quality of Life	zh-CN	10.0
移民对文化认同有影响，特别是在语言、传统和价值观方面。	Cultural Identity	zh-CN	11.0
一些人认为移民可以丰富和多样化文化体验，而另一些人则认为它可能导致民族认同感和社会凝聚力下降。	Cultural Identity	zh-CN	11.0
公众对移民的看法两极分化，一些人表示支持增加移民，另一些人则呼吁加强控制和限制。	Public Sentiment	zh-CN	12.0
媒体和政客描绘移民的方式可以影响公众舆论和政治决策。	Public Sentiment	zh-CN	12.0
移民是一个高度政治化的问题，不同的政党和利益集团在这个问题上持有不同的立场。	Political	zh-CN	13.0
移民辩论在选举期间经常成为一个政治问题，候选人在他们的平台上就这个问题采取立场。	Political	zh-CN	13.0
一个国家处理移民问题的方式会影响其声誉和与其他国家的关系，尤其是在人权和国际法方面。	External Regulation and Reputation	zh-CN	14.0
移民模式也受到外部压力和国际组织和协定的规定的影响。	External Regulation and Reputation	zh-CN	14.0
与移民相关的其他问题包括对家庭动态的影响、移民在塑造人口趋势中的作用，以及文化交流和移民融入社会。	Other	zh-CN	15.0
这些问题对该国的社会、经济和政治动态具有重要影响。	Other	zh-CN	15.0
同性婚姻可以产生积极的经济影响，促进当地企业和旅游业的发展，并增加政府的税收。	Economic	zh-CN	1.0
反对者认为，同性婚姻会破坏传统的婚姻和家庭结构，从而对经济产生负面影响。	Economic	zh-CN	1.0
同性婚姻合法化将增加同性伴侣获得资源和福利的机会，例如医疗保健和继承权。	Capacity and Resources	zh-CN	2.0
批评者认为，同性婚姻会占用资源和能力，因为它们需要改变法律框架和制度。	Capacity and Resources	zh-CN	2.0
同性婚姻的支持者认为，无论性取向如何，承认所有人的平等权利和尊严是道德上的当务之急。	Morality	zh-CN	3.0
反对者认为，同性婚姻是不道德的，违背了传统的宗教和文化价值观。	Morality	zh-CN	3.0
同性婚姻被视为 LGBTQ+ 人群公平和平等的关键问题，因为它提供与异性伴侣相同的法律权利和保护。	Fairness and Equality	zh-CN	4.0
批评者认为，同性婚姻不是一个平等问题，因为它需要重新定义婚姻的传统定义。	Fairness and Equality	zh-CN	4.0
同性婚姻的合法性争论不休，法院和政府因宪法解释和司法考虑在这个问题上意见相左。	Legality, Constitutionality, Jurisdiction	zh-CN	5.0
反对者认为同性婚姻不应该合法化，因为宪法或先例都没有明确规定同性婚姻。	Legality, Constitutionality, Jurisdiction	zh-CN	5.0
同性婚姻的政策处方因政治和文化因素而异，一些国家和地区将其合法化，而另一些国家和地区则继续禁止。	Policy Prescription and Evaluation	zh-CN	6.0
评估同性婚姻对社会和个人的影响是一个持续的过程，研究显示出积极和消极的结果。	Policy Prescription and Evaluation	zh-CN	6.0
一些司法管辖区将同性婚姻定为犯罪，个人因拥有同性关系而面临法律惩罚或社会迫害。	Crime and Punishment	zh-CN	7.0
试图使同性婚姻合法化通常被视为结束基于性取向的歧视和惩罚的一种方式。	Crime and Punishment	zh-CN	7.0
同性婚姻已被用作推进国家安全和人权议程的工具，特别是在国际关系和外交背景下。	Security and Defense	zh-CN	8.0
批评者认为，同性婚姻破坏婚姻和家庭制度，对国家安全和社会稳定产生负面影响。	Security and Defense	zh-CN	8.0
同性婚姻合法化可以让 LGBTQ+ 人群获得医疗保健、保险和法律保护，从而改善他们的健康和安全。	Health and Safety	zh-CN	9.0
反对者认为，同性婚姻不利于个人和公共健康，导致疾病传播和其他负面后果。	Health and Safety	zh-CN	9.0
通过给予 LGBTQ+ 法律认可和社会认可，同性婚姻被认为是改善 LGBTQ+ 人群生活质量的重要因素。	Quality of Life	zh-CN	10.0
批评者认为，同性婚姻通过破坏传统价值观和结构，对个人和整个社会的生活质量产生负面影响。	Quality of Life	zh-CN	10.0
同性婚姻通常被视为 LGBTQ+ 文化认同的关键问题，因为它代表了对他们在社会中的存在和权利的基本认可。	Cultural Identity	zh-CN	11.0
反对者认为，同性婚姻威胁到传统的文化认同和价值观，并可能导致社会和道德沦丧。	Cultural Identity	zh-CN	11.0
随着时间的推移，同性婚姻的舆论也在不断演变，越来越多的国家和地区接受和支持同性婚姻。	Public Sentiment	zh-CN	12.0
同性婚姻合法化的推动往往是由公众情绪驱动的，政治家和组织对不断变化的态度和意见做出回应。	Public Sentiment	zh-CN	12.0
同性婚姻问题往往是政治性的，政党和政客根据他们的价值观和意识形态采取不同的立场。	Political	zh-CN	13.0
同性婚姻合法化已成为 LGBTQ+ 权利倡导者的一个关键政治问题，他们认为这是实现更大的社会和法律平等的一种方式。	Political	zh-CN	13.0
虽然同性婚姻通常被视为社会进步和一个国家对人权承诺的衡量标准，但国际组织和盟友正在向政府施压，要求其合法化。	External Regulation and Reputation	zh-CN	14.0
反对者认为，要求同性婚姻合法化的外部压力侵犯了国家主权和文化价值观。	External Regulation and Reputation	zh-CN	14.0
同性婚姻是一个极具争议性和情绪化的问题，双方的个人和团体都在为自己的信仰和价值观而战。	Other	zh-CN	15.0
关于同性婚姻的辩论是复杂和多方面的，反映了围绕身份、价值观和权力的更广泛的社会和文化紧张局势。	Other	zh-CN	15.0
移民既有积极的经济影响，也有消极的经济影响，一些人认为它带来了宝贵的劳动力和技能，而另一些人则认为它降低了工资并损害了社会服务。	Economic	zh-CN	1.0
许多公司依赖农民工，尤其是在农业、酒店业和建筑业等行业。	Economic	zh-CN	1.0
移民给一个国家的基础设施和资源带来压力，例如B. 住房、交通和医疗保健，尤其是在服务需求高的地区。	Capacity and Resources	zh-CN	2.0
许多国家/地区根据其资源和提供支持的能力限制了他们可以接受的移民数量。	Capacity and Resources	zh-CN	2.0
一些人认为，移民是一种道德义务，可以帮助有需要的人，尤其是逃离本国暴力或迫害的难民。	Morality	zh-CN	3.0
其他人则认为，允许移民非法入境或剥削移民工人是不道德的。	Morality	zh-CN	3.0
许多人争辩说，移民政策应该基于公平和平等的原则，移民应该受到有尊严和尊重的对待。	Fairness and Equality	zh-CN	4.0
其他人则认为，优先考虑移民而不是公民是不公平和不公正的。	Fairness and Equality	zh-CN	4.0
移民政策面临法律和宪法挑战，特别是在公民身份、驱逐出境和庇护问题上。	Legality, Constitutionality, Jurisdiction	zh-CN	5.0
许多国家对移民政策有不同程度的管辖权，地方、州和联邦政府都在发挥作用。	Legality, Constitutionality, Jurisdiction	zh-CN	5.0
移民政策通常由政策规定和评估决定，专家和政策制定者会权衡不同方法的成本和收益。	Policy Prescription and Evaluation	zh-CN	6.0
一些人认为战略应该以证据为基础和数据驱动，而另一些人则强调理论或政策考虑。	Policy Prescription and Evaluation	zh-CN	6.0
移民政策通常与犯罪和惩罚问题联系在一起，一些人认为移民更有可能犯罪，应该受到更严格的执法措施。	Crime and Punishment	zh-CN	7.0
其他人则认为，移民是不公平的目标，政策应侧重于减少犯罪和改善所有居民的公共安全。	Crime and Punishment	zh-CN	7.0
移民政策影响一个国家的安全和国防，特别是在边境控制和国家身份问题方面。	Security and Defense	zh-CN	8.0
一些人认为移民威胁国家安全，而另一些人则认为这对于维持多元化和多元文化的社会至关重要。	Security and Defense	zh-CN	8.0
移民政策对公共健康和安全有影响，特别是在疾病控制和应急响应问题上。	Health and Safety	zh-CN	9.0
一些人认为移民政策应优先考虑公共健康和安全，而另一些人则认为政策应优先考虑移民和难民的需求。	Health and Safety	zh-CN	9.0
移民政策影响移民和公民的生活质量，特别是在社会凝聚力、教育和就业方面。	Quality of Life	zh-CN	10.0
一些人认为移民通过带来不同的观点和技能来改善生活质量，而另一些人则认为它会造成社会紧张和冲突。	Quality of Life	zh-CN	10.0
移民政策通常与文化认同问题相关，一些人认为移民威胁到民族认同和文化传统。	Cultural Identity	zh-CN	11.0
其他人则认为，文化认同在不断演变，移民可以丰富和多样化文化表现形式。	Cultural Identity	zh-CN	11.0
移民政策通常取决于公众对移民的情绪和态度，一些人主张更严格的执法，而另一些人则主张更广泛的政策。	Public Sentiment	zh-CN	12.0
公众情绪受到许多因素的影响，包括媒体报道、政治言论和个人经历。	Public Sentiment	zh-CN	12.0
移民政策往往受到政治考虑的影响，不同的政党和利益集团根据其价值观和意识形态采取不同的立场。	Political	zh-CN	13.0
移民政策可能是一个非常不同的政治问题，政客们用它来动员他们的基础并吸引不同的人口选区。	Political	zh-CN	13.0
移民政策会影响一个国家的外部审查和声誉，特别是在人权和国际法问题上。	External Regulation and Reputation	zh-CN	14.0
一些人认为，移民威胁到一个国家的文化认同，因为它引入了新的习俗和信仰。然而，其他人认为多样性丰富了一个社会的文化，应该受到庆祝。	Cultural Identity	zh-CN	11.0
重要的是移民要了解和尊重他们移居到的国家的文化特征，同时保留和分享他们自己独特的文化传统。	Cultural Identity	zh-CN	11.0
公众对移民的看法因地点和背景而异。在某些地区，人们对移民持欢迎态度并赞赏他们为社会提供的服务，而在其他地区，人们可能对移民抢走工作或耗尽资源感到恐惧或怨恨。	Public Sentiment	zh-CN	12.0
媒体在塑造公众对移民的情绪方面发挥着作用，关于移民犯罪的耸人听闻的故事助长了对他们的负面态度。	Public Sentiment	zh-CN	12.0
移民政策通常受政治动机影响，政客试图通过吸引他们的支持者或对移民采取强硬立场来赢得选票。	Political	zh-CN	13.0
国际关系也可以影响一个国家的移民政策，外交考虑和协议会影响移民的流动。	Political	zh-CN	13.0
联合国和欧盟等国际组织和条约在规范和制定移民政策方面发挥着作用。	External Regulation and Reputation	zh-CN	14.0
一个国家作为欢迎或敌对移民的地方的声誉具有重大的经济和政治影响，影响旅游业、贸易和外交关系。	External Regulation and Reputation	zh-CN	14.0
移民可以对一个国家产生积极和消极的经济影响，例如B. 通过提供廉价劳动力来源，同时增加对工作和资源的竞争。	Economic	zh-CN	1.0
一个国家接收和支持移民的能力受到其住房、教育、医疗保健和其他资源能力的限制。	Capacity and Resources	zh-CN	2.0
对移民的伦理思考包括关于移民权利和接收国对他们的责任的问题。	Morality	zh-CN	3.0
移民政策应该公平公正，确保所有移民都获得公平和平等的机会。	Fairness and Equality	zh-CN	4.0
移民法律和政策必须符合法律和宪法原则，并且是执行它们的政府的责任。	Legality, Constitutionality, Jurisdiction	zh-CN	5.0
有效的移民政策需要仔细评估和考虑目标、影响和实施策略。	Policy Prescription and Evaluation	zh-CN	6.0
移民可能与犯罪和惩罚问题有关，包括对边境安全和移民犯罪活动的担忧。	Crime and Punishment	zh-CN	7.0
移民政策对国家安全和国防有影响，包括来自恐怖组织和地缘政治冲突的潜在威胁。	Security and Defense	zh-CN	8.0
必须在移民政策的背景下考虑移民和东道社区的健康和安全，包括疾病控制和环境卫生等问题。	Health and Safety	zh-CN	9.0
移民影响移民和东道社区的生活质量，影响社会凝聚力、公共服务和文化融合。	Quality of Life	zh-CN	10.0
移民塑造了一个国家及其人民的文化认同，对多样性和社会凝聚力产生了积极和消极的影响。	Cultural Identity	zh-CN	11.0
公众对移民的态度和看法具有重要的政治和社会影响。	Public Sentiment	zh-CN	12.0
移民政策通常受到政治考虑因素的影响，例如选举策略和政党意识形态。	Political	zh-CN	13.0
国际组织和条约在制定和规范移民政策方面发挥着作用，影响着一个国家的声誉和全球地位。	External Regulation and Reputation	zh-CN	14.0
同性婚姻是一个道德和伦理问题，因为人们的性取向而剥夺他们结婚的权利是歧视性和不公平的。	Morality	zh-CN	3.0
所有人，无论其性取向如何，都应有权结婚，并享有与异性恋伴侣相同的法律利益和保护。	Fairness and Equality	zh-CN	4.0
因为性取向而剥夺人们结婚的权利是不公正和不道德的。	Morality	zh-CN	3.0
所有人，无论其性取向如何，都应有权结婚，并享有与异性恋伴侣相同的法律利益和保护。	Fairness and Equality	zh-CN	4.0
随着时间的推移，世界许多地方对同性婚姻的接受度不断提高，人们对同性婚姻的态度也发生了变化，但仍有待克服重大的文化和社会障碍。	Public Sentiment	zh-CN	12.0
与同性婚姻相关的政策和法律对社会有重大影响，重要的是评估其影响并做出必要的改变以确保公平和平等。	Policy Prescription and Evaluation	zh-CN	6.0
同性婚姻合法化具有经济效益，因为它可以促进旅游业并在婚礼行业创造新的商机。	Economic	zh-CN	1.0
虽然同性婚姻可以挑战传统的性别角色和社会规范观念，但一些人认为它可以帮助培养更多样化和更可接受的文化认同。	Cultural Identity	zh-CN	11.0
剥夺同性伴侣结婚的权利会对他们的健康和福祉产生负面影响，因为他们面临歧视并且无法获得重要的法律和经济保护。	Health and Safety	zh-CN	9.0
同性婚姻辩论是许多国家的一个重大政治问题，政党和政治家根据他们的信仰和选民的观点在这个问题上采取不同的立场。	Political	zh-CN	13.0
同性婚姻合法化是 LGBTQ+ 社区迈向平等的重要一步，确保他们拥有与异性伴侣相同的权利和机会。	Fairness and Equality	zh-CN	4.0
对许多人来说，同性婚姻是一个道德问题，一些人认为它违背了传统价值观，而另一些人则坚持不分性别地庆祝爱情和结合。	Morality	zh-CN	3.0
剥夺同性伴侣结婚的权利明显侵犯了他们平等和不受歧视的基本人权。	Fairness and Equality	zh-CN	4.0
同性婚姻为夫妻提供重要的健康益处，例如： B. 医疗福利、保险保障和就医权，这在生病或紧急情况下至关重要。	Health and Safety	zh-CN	9.0
在拜登总统周一公布计划之前，一位熟悉预算草案的官员在匿名的情况下提供了资金申请的细节。	Capacity and Resources	zh-CN	2.0
ICE 将与 ERO、OPR 和国土安全部内的其他监管机构合作，继续检查个别拘留设施，以确保条件适当。	Capacity and Resources	zh-CN	2.0
HSI 与联邦调查局合作，使司法部能够对这起犯罪中的两名同谋提出指控。	Capacity and Resources	zh-CN	2.0
拘留管理与 25 个 ERO 外地办事处协调，通过设施合规、现场监控和拘留设施采购，确保 ICE 拘留中的非公民有一个安全的环境。	Capacity and Resources	zh-CN	2.0
通过制定、实施和监督计划和程序以支持整个国家逃亡行动计划任务，促进对 25 个 ERO 外地办事处逃亡行动的后勤和运营支持。	Capacity and Resources	zh-CN	2.0
这些中心运用技术技能、分析工具和执法专业知识来生成基于情报的非公民驱逐出境线索。	Capacity and Resources	zh-CN	2.0
通过数据收集、分析以及技术和流程改进，LESA 提供工具、研究和建议来支持 ICE 的决策和规划。	Capacity and Resources	zh-CN	2.0
该部门通过与机构间和机构间利益相关者、外国大使馆和领事馆以及国际合作伙伴合作，为等待驱逐出境的非美国公民制定和实施驱逐出境战略。	Capacity and Resources	zh-CN	2.0
我们支持全球人权政策以及对移民和难民的保护，并敦促采取多边行动解决移民的根本原因，包括气候变化。	Capacity and Resources	zh-CN	2.0
PA 是一个非营利组织，符合州和计划资格标准，并具有代表 CDSS 管理指定计划和计划资金的行政能力。	Capacity and Resources	zh-CN	2.0
如果您在美国没有获得移民官员的许可或假释，您的非法居留将从您在没有许可或假释的情况下进入该国之日算起。	Crime and Punishment	zh-CN	7.0
一般来说，如果您已获准进入美国或被移民官假释，您将收到一份 Iâ94 表格，即到达/离开记录，其中包含您计划离开的确切日期。	Crime and Punishment	zh-CN	7.0
如果您在递解程序（包括自愿递解程序）开始后离开美国，您有责任通知移民审查执行办公室。	Crime and Punishment	zh-CN	7.0
无论您是在国土安全部开始遣返程序之前、期间还是之后离开，10 年禁止出席都适用。	Crime and Punishment	zh-CN	7.0
即使您因为这个原因没有被永久接纳，您也可以申请重新申请进入美国的许可，但前提是您自上次离开美国以来已经实际离开美国至少 10 年。	Crime and Punishment	zh-CN	7.0
根据您申请的移民福利，法律可能会因不可入境而取消您的资格。	Crime and Punishment	zh-CN	7.0
你应该写“在三年或十年的合法期限内返回美国”，以方便识别并避免延迟提交拒绝。	Crime and Punishment	zh-CN	7.0
《移民和国籍法》(INA) 概述了个人不可入境的理由。	Crime and Punishment	zh-CN	7.0
由于非法移民多年未被发现，得克萨斯州的非法移民罪犯人数仍然很少。	Crime and Punishment	zh-CN	7.0
专为衡量人们报案意愿而设计的全国犯罪受害调查显示，包括没有公民身份的西班牙裔美国人在内的移民报案的可能性略高于当地人。	Crime and Punishment	zh-CN	7.0
文化同化是指少数群体或文化采纳所在国多数群体的行为、价值观、习俗和信仰的过程。	Cultural Identity	zh-CN	11.0
文化同化一词通常用于描述迁移到新地方的移民；但是，它也用于讨论土著群体。	Cultural Identity	zh-CN	11.0
土著、移民和少数民族经常改变或隐藏他们自己文化的各个方面，包括他们的语言、饮食、服饰和精神习俗，以采纳主流文化的价值观和社会行为。	Cultural Identity	zh-CN	11.0
重要的是要记住，自愿动员通常是对来自更主流文化的压力的回应，而从众是人们保持安全和生存的一种解决方案。强迫同化：这是少数民族或土著群体被迫投降的情况。他们的文化认同、语言、规范和习俗适合占主导地位的群体。	Cultural Identity	zh-CN	11.0
虽然这是各州共同的过程，但它仍然是一个有分歧的政治问题——一些政客和公众认为，欧洲移民比过去的少数群体更快地被同化。	Cultural Identity	zh-CN	11.0
今天和过去，这个国家的许多白人将移民和少数民族视为对国家文化的威胁，害怕我们之间的差异，并对那些不这样做的人施加直接和间接的压力，包括威胁。和暴力。	Cultural Identity	zh-CN	11.0
文化同化旨在限制自我隔离，然而这一时期的移民被鼓励同化以实现社会稳定和经济繁荣。	Cultural Identity	zh-CN	11.0
另一项针对移民家庭的研究发现，拥有更多外国名字的兄弟姐妹失业率更高，完成学业的年限更少，收入更少，并且更有可能与外国出生的配偶结婚。	Cultural Identity	zh-CN	11.0
尽管强迫同化是一种暴力形式，但强迫少数群体采用不属于他们自己的文化习俗往好里说是有问题的，往坏里说是暴力行为。	Cultural Identity	zh-CN	11.0
土著人民、少数民族和移民往往以不同的方式经历同化，因此仔细讨论和思考同化是如何发生的以及它产生的影响是很重要的。	Cultural Identity	zh-CN	11.0
在酒店业，38% 的企业主出生在美国以外，而零售业主的这一比例为 24%。	Economic	zh-CN	1.0
8500 万美国人生活在 2011-2021 年失去主要工作年龄成年人的县，1.6 亿美国人生活在人口减少或停滞的县，是时候开始讨论 Redesign 中的移民与当地和区域经济发展的关系了.	Economic	zh-CN	1.0
美国人口最多的 20 个州 这些县占全国拥有至少学士学位的移民的 36%，而全国总人口的这一比例仅为 19%。	Economic	zh-CN	1.0
州和地方政客尤其需要创建一个自下而上的框架，以了解为什么移民对美国很重要，并更好地理解移民为其社区带来的价值。	Economic	zh-CN	1.0
TEA 的最低投资增加到 900,000 美元（从 500,000 美元）以应对通货膨胀。	Economic	zh-CN	1.0
DHS 遵循附录 [DHS/USCIS/ICE/CBP-001 外国人文件和国家文件跟踪记录系统、DHS/USCIS-007 福利信息系统和 DHS/USCIS- 018 Immigration Biometric and Background ] 并发布了隐私影响评估 [DHS/USCIS/PIA-016(a) Computer Linked Application Information System and Associated Systems]，可在 www.dhs.gov/privacy 找到。	Economic	zh-CN	1.0
即使将工资差异的 10% 用于一年的往返旅行费用，也可以让这些低技能工人在美国找到工作，而不是将他们遣送回国。一项有效、设计良好和实施良好的反贫困计划可以使收入增加至最初开始时的 35 倍。	Economic	zh-CN	1.0
但富国和穷国之间现有的工资差异，以及对劳动力不可否认的需求，意味着任何人员流动都是在没有合法授权和雇主合作的情况下发生的。	Economic	zh-CN	1.0
移民对工资的影响对于受教育程度较低的本土工人和从事移民比例高的职业的人来说是负面的。4 除了对工资的影响外，移民还影响就业。本地工人的机会。	Economic	zh-CN	1.0
大量移民涌入导致就业竞争加剧，导致本地出生工人的工作机会减少。然而，移民对就业机会的影响很小。6 移民对美国经济的净影响是积极的。7 移民增加了经济中的工人数量，导致更高的经济增长和本地出生工人的更高工资。	Economic	zh-CN	1.0
新规则允许庇护官员在移民出现在美国南部边境时审理和决定庇护申请（通常分配给移民法官的案件），从而赋予他们更多权力。	External Regulation and Reputation	zh-CN	14.0
移民治理指标 (MGI) 提供了一个框架来评估国家移民政策的完整性，并帮助确定机构能力发展和移民计划的差距和优先事项。	External Regulation and Reputation	zh-CN	14.0
每个保单类别的各个子维度都被考虑在内，包括资格、条件、身份保障和相关权利。	External Regulation and Reputation	zh-CN	14.0
指标面板分为五个政策维度：制度一致性、降低移民成本、保护移民和家庭权利、促进融合和重返社会以及增加移民对发展的影响。	External Regulation and Reputation	zh-CN	14.0
移民条例载于联邦法规第 8 篇（外国人和国籍），相当于美国法典第 8 篇（外国人和国籍）。	External Regulation and Reputation	zh-CN	14.0
促进性别平等和正义的需求和挑战在世界各地都很明显。	Fairness and Equality	zh-CN	4.0
白宫、国务院和美国驻联合国代表团、美国政府在最高政治层面建立了卓越的领导能力和能力，包括国际开发署 (USAID) 和卫生与公众服务部。和人类服务 (HHS)。	Fairness and Equality	zh-CN	4.0
在特朗普政府继续攻击性别问题，特别是性和生殖健康以及 LGBTQI+ 权利之后，拜登政府面临着推进实现美国与全球健康和发展相关目标所需的平等和性别平等的战略要务。 、经济繁荣和国家安全，并证明这是可以实现的。	Fairness and Equality	zh-CN	4.0
虽然其他政府设有专门针对妇女和女孩的办公室，但现任白宫性别政策委员会是总统行政办公室中第一个关注性别平等和性别平等的政策委员会，包括妇女和女孩，但更具包容性和更广泛的性别议程，包括 LGBTQI+ 问题。	Fairness and Equality	zh-CN	4.0
召集和协调跨部门进程可能仍由白宫负责，白宫必须管理跨部门和跨部门的紧张关系和竞争，需要政府提供一致的高层支持和人员配备。	Fairness and Equality	zh-CN	4.0
根据美国商会的说法，多样性、公平和包容性（通常称为 DEI）是适用于专业环境的社会改革框架。	Fairness and Equality	zh-CN	4.0
大流行加剧了移民面临的健康和经济挑战，随着美墨边境地区移民活动的增加，解决移民的需求变得越来越重要。	Health and Safety	zh-CN	9.0
尽管许多非老年公民住在有全职雇员的家庭中，但他们在获得私人保险方面面临差距，因为他们更有可能从事低薪和低薪工作以及不太可能提供养老金雇主的行业. - 赞助报道	Health and Safety	zh-CN	9.0
一些移民，例如B. 临时保护身份的持有人是合法的，但不具有合格身份，并且没有资格加入 Medicaid 或 CHIP，无论他们在该国停留的时间如何。	Health and Safety	zh-CN	9.0
根据 Medicare 和 Medicaid 服务中心 (CMS) 发布的规定，具有童年抵达暂缓遣返身份的人在健康保险资格方面不被视为合法存在，也没有资格获得保险选择。	Health and Safety	zh-CN	9.0
尽管有资格获得保险，但许多移民家庭仍然没有保险，因为他们在注册时面临许多障碍，包括恐惧、对资格程序的困惑、注册过程中的困难以及语言和识字问题。	Health and Safety	zh-CN	9.0
研究表明，特朗普政府改变移民政策导致移民家庭越来越担心自己和/或他们的孩子参加医疗补助和 CHIP，即使他们符合条件。	Health and Safety	zh-CN	9.0
“各州已通过旨在禁止各类人群进入其州界的法律，包括那些有犯罪记录的人、依赖公共援助的人、奴隶和自由黑人，”詹妮弗查孔解释说。	Legality, Constitutionality, Jurisdiction	zh-CN	5.0
“阿曼达·弗罗斯特 (Amanda Frost) 是我们教职员工中令人兴奋的新成员，她在移民和宪法方面拥有专业知识和经验，”院长里萨·戈卢博夫 (Risa Goluboff) 说。	Legality, Constitutionality, Jurisdiction	zh-CN	5.0
“当我偶然发现美国历史上人们失去公民身份的故事时，我萌生了写这本书的想法，我意识到剥夺公民身份的现象比我最初想象的要广泛得多，”弗罗斯特说。	Legality, Constitutionality, Jurisdiction	zh-CN	5.0
看到工作中的刑事司法系统，她“想成为其中的一部分，代表那些不想被听到的人。”大学毕业后，她作为民权法的律师助理工作了一年。机构并申请在她的母校学习法律。	Legality, Constitutionality, Jurisdiction	zh-CN	5.0
“我发现 [与移民有关的] 问题在各个方面都很有趣，从政治问题到法律解释，再到关于国家三个分支之间关系的复杂宪法问题，”她说。	Legality, Constitutionality, Jurisdiction	zh-CN	5.0
州政府官员也被允许通过拘留以前被判有罪的移民来执行联邦移民法。	Legality, Constitutionality, Jurisdiction	zh-CN	5.0
你可能想知道，如果你看着这位警官说，“你不能仅仅通过看着我就知道我是个好人吗？”不幸的是，这不是真的。足够的	Morality	zh-CN	3.0
因此，如果您吸食医用大麻或消遣性吸食大麻，即使在您所在的州是合法的并且您从未因受控物质被捕或被定罪，您也可能被认为在道德上低人一等。	Morality	zh-CN	3.0
道德品质和合法永久居民 (LPR)。如果您是合法永久居民 (LPR) 并希望申请美国入籍/公民身份，您必须在您作为合法永久居民期间向 USCIS 官员展示可接受的道德品质。	Morality	zh-CN	3.0
移民法庭的道德品质和程序。当个人受到 USCIS 的驱逐出境或遣返程序时，需要提供良好道德品质的证明。	Morality	zh-CN	3.0
在一个典型的例子中，当一个人因为严重的创伤或情感虐待而申请美国公民身份时，他们在美国期间取得的重大成就的证据可能会破坏该人的整个案件。	Morality	zh-CN	3.0
如果他们在第一年不申请，他们将失去获得庇护的机会。	Other	zh-CN	15.0
超过 200,000 名阿富汗人、乌克兰人、委内瑞拉人、尼加拉瓜人、古巴人和海地人通过了更正式的人道主义假释程序。	Other	zh-CN	15.0
在移民激增和美墨边境危机的背景下，白宫和国土安全部的官员已经开始讨论采取更多限制措施来禁止移民进入美国。	Other	zh-CN	15.0
一位政府官员在一份声明中说：“出于良好治理的原因，我们在推进任何政策之前会考虑所有法律因素，最近提议的规则反映了这些因素。”	Other	zh-CN	15.0
消息人士告诉美国有线电视新闻网，由于官员拘留了创纪录数量的抵达美国南部边境的移民，改革移民制度的提议已被搁置。	Other	zh-CN	15.0
“这不是我们的首要任务，甚至不是我们的第二要务，”一位政府官员此前告诉记者，强调努力开放进入美国的合法途径，包括使用该应用程序，并强调国会有责任通过改革。 .	Other	zh-CN	15.0
作为移民体检的一部分，申请人、民事外科医生和任何其他对申请人进行评估的医疗保健提供者必须签署表格并证明其声明的内容是真实的。	Policy Prescription and Evaluation	zh-CN	6.0
如果难民只需要疫苗接种测试，则表格中唯一需要填写的部分是申请人信息、疫苗接种测试和证书。	Policy Prescription and Evaluation	zh-CN	6.0
USCIS 可能会接受一名受特定身体或发育残疾或精神障碍影响的申请人，而另一名受相同残疾或障碍影响的申请人有资格获得残疾豁免。	Policy Prescription and Evaluation	zh-CN	6.0
残疾豁免只能通过提交 N-648 表格获得，需要证明申请人的身体或精神残疾或精神障碍妨碍申请人满足英语或公民或两者的要求。合理的住宿。	Policy Prescription and Evaluation	zh-CN	6.0
为医疗远程医疗考试提供口译服务的口译员无需填写 N-648 表的口译员证明。	Policy Prescription and Evaluation	zh-CN	6.0
多年来，国会一直未能就全面移民改革达成一致，实际上将一些关键政策决定转移到了政府的行政和司法部门，并在州和地方政府的大厅里引发了争论。	Political	zh-CN	13.0
拜登扭转特朗普时代政策的举措包括减少美国的移民执法、结束旅行禁令、取消绿卡处理的暂停，以及停止在美墨两国边境修建隔离墙。	Political	zh-CN	13.0
与此同时，南部边境历史性的移民涌入有可能进一步破坏拜登的努力：在与大流行相关的下降之后，边境逮捕人数在 2022 年 5 月上升至近 240,000 人，为 20 年来的最高水平。	Political	zh-CN	13.0
在 2022 年美洲峰会期间，23 位西半球领导人就移民协议达成一致，旨在增加对难民人口的援助、改善边境管理并更好地协调应急响应。	Political	zh-CN	13.0
拜登和墨西哥总统安德烈斯·曼努埃尔·洛佩斯·奥夫拉多尔也访问了美国南部。提出了一项联合基础设施计划以确保边境安全，重点是扩大临时工作签证和增加对边境监视的投资。	Political	zh-CN	13.0
“在 20 年代之前，移民话语的总体趋势是负面的，但在一代人中——从 1945 年到 1965 年——它变得非常积极，”经济学教授和经济史学家罗恩·阿布拉米茨基 (Ron Abramitzky) 说。斯坦福大学与 AI 研究人员合作发表了一篇新论文。	Public Sentiment	zh-CN	12.0
除了 Card 和 Abramitzky，该团队还包括斯坦福计算机科学家 Serena Chang； Chris Becker，斯坦福经济学家； Julia Mendelsohn，密歇根大学信息科学家； Dan Jurafsky，斯坦福大学语言学和计算机科学教授； Leah Boston，普林斯顿大学经济学教授；西北大学语言学助理教授 Rob Voigt。	Public Sentiment	zh-CN	12.0
为了训练能够准确识别移民语调的机器学习模型，该团队首先手动注释人类研究助理演讲的样本，以确定他们是积极的、消极的还是中立的，以及他们如何描述移民的特征。	Public Sentiment	zh-CN	12.0
最近政治演讲中支持移民的基调反映了全国日益增长的积极情绪。	Public Sentiment	zh-CN	12.0
正如上个月报道的那样，涉及种族的非法移民是一个公众关注的问题，在今年评估的 14 个问题中排名倒数第二。	Public Sentiment	zh-CN	12.0
“拜登总统没有必要推动庇护禁令，我们正在动员人们大声疾呼反对这种骇人听闻的不法行为，”#WelcomeWithDignity 联盟的临时竞选经理 Bilal Askyar 说。移民法和法律机构。	Public Sentiment	zh-CN	12.0
世界卫生组织将 QoL 定义为通过一个人的文化和价值体系的镜头观察一个人对与一个人的目标相关的现实感知的主观评估。	Quality of Life	zh-CN	10.0
对于那些以毫无根据、虚假或无理取闹的要求滥用我们的庇护制度的人来说，这将花费数百万美元的行政费用和法律援助——请参阅关于我们负担过重和滥用庇护制度成本上升的简报	Quality of Life	zh-CN	10.0
交通拥堵越来越严重——交通数据公司 Inrix 发现，伦敦现在是世界上最拥堵的城市，日益恶化的拥堵促使政府做出转向“智能高速公路”的愚蠢决定。通过摆脱硬肩，降低驾驶安全性并使家庭处于危险之中。	Quality of Life	zh-CN	10.0
所有这一切还没有提到由于无法识别数以万计的轮船、飞机和卡车非法入境者而造成的公共安全噩梦——加上入境者故意销毁身份证件的倾向。 .	Quality of Life	zh-CN	10.0
歧视非公民的法律以及未能解决他们的具体需求和脆弱性的计划和政策常常使家庭及其家人无法获得基本服务。	Quality of Life	zh-CN	10.0
妇女的移徙能力可能受到个人和家庭因素的限制，例如年龄、家庭资历、种族/族裔、婚姻状况和有无子女。	Quality of Life	zh-CN	10.0
由于他们的种族信仰，移民被剥夺人性、被定罪、被任意拘留，有时甚至与他们的孩子分开。	Quality of Life	zh-CN	10.0
设置障碍物和围墙是因为人们相信，阻挡安全有序的行动路线并故意收紧路线会降低人们离开自己土地的意愿。	Quality of Life	zh-CN	10.0
移民必须证明他们害怕返回原籍国后会受到迫害。	Quality of Life	zh-CN	10.0
这个数字是通过对全国各地的人们进行的各种主题调查确定的，这些主题包括住房负担能力、生活成本、旅行时间、污染、犯罪、健康、购买力、娱乐、就业等等。	Quality of Life	zh-CN	10.0
自 9/11 以来，国土安全部 (DHS) 和联邦政府及其在全国和世界各地公共和私营部门和社区的许多合作伙伴一直致力于大幅缩减和增加新的国土安全实体保护。动态威胁，降低风险并提高响应所有类型的攻击和灾难并从中恢复的能力。	Security and Defense	zh-CN	8.0
公民及移民服务局 (USCIS) 更新了就业授权文件，添加了一个机器可读区域，使边境管制官员能够更有效地识别已经获得移民批准并之前由美国公民及移民服务局官员筛选过的个人。	Security and Defense	zh-CN	8.0
美国海岸警卫队通过创建可部署作战小组增加了海军力量的存在和应对威胁的能力，该小组是与恐怖主义和大规模杀伤性武器并驾齐驱的美国重要力量。能够快速响应海上安全和港口安全团队。内河航行威胁和事后响应。	Security and Defense	zh-CN	8.0
辐射检测：海关和边境保护局已在世界各地的海港、陆路边境口岸和邮政设施部署了辐射门户监测器和其他辐射检测技术。	Security and Defense	zh-CN	8.0
自 9/11 以来，国土安全部 (DHS) 和联邦政府及其在全国和世界各地公共和私营部门和社区的许多合作伙伴一直致力于大幅缩减和增加新的国土安全实体保护。动态威胁，降低风险并提高响应所有类型的攻击和灾难并从中恢复的能力。	Security and Defense	zh-CN	8.0
当代读者可以惊叹于 20 世纪初女性和男性俱乐部为自由债券筹款而举办的“男女”婚礼。	Capacity and Resources	zh-CN	2.0
她还讨论了同性恋的文化方面，例如包括耶稣在内的男人和女人、虚构的婚姻和马克吐温的故事——南希·杰克逊如何与凯特·威尔逊结婚，他认为凯特·威尔逊太危险以至于他不敢发表她的作品。	Capacity and Resources	zh-CN	2.0
随后进行了一项特别审判：在 1923 年的芝加哥谋杀案审判中，法官裁定“汤普森是男人这一事实并不影响他作为妻子的地位，这是对法律的解释问题。汤普森不被允许作证，因为当时的妻子不能为丈夫作证。	Capacity and Resources	zh-CN	2.0
同性伴侣——以及被奴役的伴侣、混血伴侣、自我离婚的伴侣和一夫多妻——在国家看来可能合法也可能不合法，但它们仍然存在。	Capacity and Resources	zh-CN	2.0
正如克利夫斯所问，“他们应该被理解为同性恋，还是应该被陷害在一个仍在从男女同性恋历史中解释的跨性别故事中？	Capacity and Resources	zh-CN	2.0
在有禁令的州已经结婚的 LGBTQ+ 人仍然可以结婚。	Crime and Punishment	zh-CN	7.0
想要在 32 个没有平等婚姻权利的州结婚的 LGBTQ+ 人必须跨州结婚，并让他们的结合得到他们所在州的承认。	Crime and Punishment	zh-CN	7.0
该法案对禁止 LGBTQ+ 婚姻的州的已婚人士意味着什么？	Crime and Punishment	zh-CN	7.0
如果最高法院否决婚姻平等，是否有办法在全国范围内恢复婚姻平等？	Crime and Punishment	zh-CN	7.0
推翻罗伊案的多数法官之一克拉伦斯·托马斯 (Clarence Thomas) 撰写了一份共识意见，认为法院应该“重新考虑”奥伯格费尔，称这是法院的错误决定之一。它在原地停留的时间比被撞倒时的 Ro 短得多。	Crime and Punishment	zh-CN	7.0
同性伴侣已经赢得了婚姻平等的斗争，并且可以享受联邦和州法律提供的许多（如果不是全部）婚姻福利。	Economic	zh-CN	1.0
在一些州和哥伦比亚特区，已婚夫妇可以获得资产的所有权，例如他们的家庭和银行账户，这限制了债权人附加特别所有权资产的方式。	Economic	zh-CN	1.0
对于领取相同员工福利的未婚同居伴侣（如果雇主也向同居伴侣提供福利），同居伴侣福利的价值通常等于雇员在联邦所得税中的应税收入。	Economic	zh-CN	1.0
现在同性婚姻得到承认，同性伴侣可以放心，因为他们知道在为生病的配偶做决定时他们是合法的近亲，并且可以控制配偶的财产。死亡，缺乏其他安排。	Economic	zh-CN	1.0
同性婚姻的经济影响对婚礼行业以及州和地方经济都是积极的。	Economic	zh-CN	1.0
包括联合国在内的国际组织已经发布了支持 LGBTQ+ 权利的决议，但人权组织表示，这些组织执行这些决议的权力有限。	External Regulation and Reputation	zh-CN	14.0
“没有一个理智的外交官认为访问一个还没有为同性婚姻做好准备的国家是个好主意，”多尔夫说。	External Regulation and Reputation	zh-CN	14.0
虽然公众对同性婚姻的支持有所增加，但法律平等的倡导者与反对基于宗教信仰的婚姻平等的个人和组织之间的争论仍在继续。	External Regulation and Reputation	zh-CN	14.0
20 世纪后期，随着对同性恋的态度和管理同性恋行为的法律的自由化，尤其是在西欧和美国，学者和公众对这一主题越来越感兴趣。	Cultural Identity	zh-CN	11.0
在 21 世纪初，许多国家和地方司法管辖区将同性婚姻合法化。在其他司法管辖区，已经采取宪法措施来防止允许同性婚姻，或者已经颁布法律拒绝承认在其他地方缔结的此类婚姻。	Cultural Identity	zh-CN	11.0
不同群体对同一行为的分析截然不同，这表明它作为 21 世纪初社会问题的重要性；它还显示了文化多样性在国家内部和国家之间持续存在的程度。	Cultural Identity	zh-CN	11.0
记录在案的最常见形式是普通法婚姻；所有权和财产不传给子女的摩根婚姻；换婚，即一个家庭中的一个兄弟姐妹与另一个兄弟姐妹结婚；以及基于一夫多妻制（妻子）或一夫多妻制（丈夫）的群婚。	Cultural Identity	zh-CN	11.0
宗教和世俗对婚姻和性的期望\n随着时间的推移，巴霍芬和摩根等人记录的历史和传统文化慢慢屈服于殖民主义强加的同质化。	Cultural Identity	zh-CN	11.0
包括联合国在内的国际组织已经发布了支持 LGBTQ+ 权利的决议，但人权组织表示，这些组织执行这些决议的权力有限。	Fairness and Equality	zh-CN	4.0
与此同时，自 2017 年以来，在俄罗斯的半自治共和国车臣共和国，数十名涉嫌同性恋的男子在两次独立的官方突击行动中被捕、遭受酷刑并被杀害。	Fairness and Equality	zh-CN	4.0
泰国和越南的立法者已考虑将同性婚姻或民事结合合法化的法案。	Fairness and Equality	zh-CN	4.0
根据 ILGA 的数据，加勒比地区对同性婚姻合法化的支持率也很低，牙买加只有 16%，多米尼加共和国只有 23%。	Fairness and Equality	zh-CN	4.0
在发现同性婚姻问题严重的群体中，配偶、父母和子女的法律关系也往往重叠。	Health and Safety	zh-CN	9.0
与婚姻的再生模式相反，同性婚姻合法化的支持者普遍认为，涉及性亲密的忠诚伙伴关系是有价值的，因为它们以独特的方式和独特的方式将人们聚集在一起。	Health and Safety	zh-CN	9.0
其他一些国家有伊斯兰宪法，通常被解释为禁止同性伴侣结婚。	Legality, Constitutionality, Jurisdiction	zh-CN	5.0
在美国，1987年在华盛顿举行的第二次全国同性恋权利大游行后，同性婚姻成为同性恋权利运动的正式诉求。	Legality, Constitutionality, Jurisdiction	zh-CN	5.0
在其他国家/地区，已经通过的宪法包含声明婚姻是男女之间的措辞，但是，特别是在较早的宪法中，它们不一定是禁止同性婚姻的措辞。	Legality, Constitutionality, Jurisdiction	zh-CN	5.0
他们还说，引入单独的立法（例如民事伴侣关系）来代替同性婚姻是不可接受的和歧视性的。	Legality, Constitutionality, Jurisdiction	zh-CN	5.0
尽管它们相对独立，但一些机构完全承认同性伴侣关系。	Legality, Constitutionality, Jurisdiction	zh-CN	5.0
尽管同性婚姻在世界上大多数国家都受到法律、宗教和习俗的规范，但法律和社会的反应从一方面庆祝到另一方面定罪。	Morality	zh-CN	3.0
在 20 世纪末和 21 世纪初，一种或多种世界宗教——佛教、印度教、犹太教、伊斯兰教和基督教——的观点及其各自的民法实践经常在关于同性婚姻的全国辩论中被引用。	Morality	zh-CN	3.0
在伊朗，强烈的穆斯林宗教信仰将同性恋定为犯罪，在丹麦也是如此，福音派路德教会主教（代表国教）会议的调查结果为第一个国家承认水平铺平了道路。通过注册伙伴关系的同性关系。	Morality	zh-CN	3.0
在其他情况下，占主导地位的宗教支持的文化同质性并没有将教义转移到民事领域，尽管它可能在公民中引发了一些敏感的讨论：例如，比利时和西班牙尽管官方反对，但仍将同性婚姻合法化来自他们的主要宗教机构，罗马天主教会。	Morality	zh-CN	3.0
但在最高法院裁定 Roe v.韦德的推翻引发了新的担忧，即该国最高法院也将重新考虑与婚姻平等相关的其他权利。 .	Other	zh-CN	15.0
拜登坚称这些话“未来几年没有计划”，这代表了这位长期居住在华盛顿的人的惊人个人发展，作为参议员，他曾投票阻止联邦政府承认同性婚姻，而此前他只坚持婚姻。介于男人和女人之间的位置。	Other	zh-CN	15.0
仍然存在暴力和仇恨；变性人权利、变性人运动员、性别肯定的医疗保健以及在学校为变性人青年提供 LGBTQ 主题和角色的书籍。	Policy Prescription and Evaluation	zh-CN	6.0
机会主义的右翼政客通过在误解这些问题的边缘化人群中煽动毫无根据的恐惧来获得权力，然后保护自己不受目标群体的伤害。	Policy Prescription and Evaluation	zh-CN	6.0
在参议院，作为总统候选人和副总统，他总是对 LGBT 问题非常警惕，担心对手会采取任何可能被用来将他描绘成左派的立场，“订婚：美国区的作者 Sasha Issenberg世纪同性婚姻之战，”CNN 说。	Policy Prescription and Evaluation	zh-CN	6.0
他们包括同性恋权利活动家伊迪·温莎的妻子朱迪思·卡森-温莎； Matthew Haynes，科罗拉多斯普林斯 LGBTQ 俱乐部 Club Q 的共同所有人，上个月枪手在一次大规模枪击事件中杀死了 5 人； Club Q 射击幸存者 James Slough 和 Michael Anderson；许多原告在 Obergefell v.具有里程碑意义的民权案件霍奇斯案于 2015 年裁定，同性伴侣可以在全国范围内结婚。	Policy Prescription and Evaluation	zh-CN	6.0
众议院周四通过了保护同性婚姻和跨种族婚姻的立法，这是该法案提交总统乔·拜登签署并成为法律之前的最后一步。	Policy Prescription and Evaluation	zh-CN	6.0
总统乔·拜登周二签署了具有里程碑意义的新联邦保护同性伴侣和混血伴侣的协议，限制了个人和国家在过去十年中越来越被接受的问题上的发展。	Political	zh-CN	13.0
拜登在南草坪当着数千名受邀嘉宾的面签署了《尊重婚姻法》，白宫称这反映了当下的重要性。	Political	zh-CN	13.0
尽管多年来公众对同性婚姻的看法一直在波动，但华盛顿的许多人似乎不太可能通过这样的法案：根据该非营利组织的民意调查，68% 的美国人在 2021 年支持同性婚姻，比 2014 年上升了 14 个百分点，无党派公共宗教研究所。	Political	zh-CN	13.0
拜登坚称这些话“未来几年没有计划”，这代表了这位长期居住在华盛顿的人的惊人个人发展，作为参议员，他曾投票阻止联邦政府承认同性婚姻，而此前他只坚持婚姻。介于男人和女人之间的位置。	Political	zh-CN	13.0
“正如你所看到的，昨天在众议院有非常好的两党支持，我希望你也可能在参议院看到这一点，”他说。	Political	zh-CN	13.0
几乎一半高中以下学历的人（51%）表示同性婚姻对社会非常好（26%）或比较好（25%），而 45% 的人表示不好（20%）。非常糟糕（24%）。	Public Sentiment	zh-CN	12.0
尽管无论美国人的年龄和教育背景如何，党派差异都很明显，但这些差异在年轻人中比在老年人中更为温和。	Public Sentiment	zh-CN	12.0
与年长的共和党人相比，年轻的共和党人对同性婚姻表达了更积极的看法，而民主党人之间的年龄差距则不那么明显。	Public Sentiment	zh-CN	12.0
民主党人的教育差距略大于共和党人。	Public Sentiment	zh-CN	12.0
即使是像前总统巴拉克奥巴马这样备受瞩目的民主党人也不愿意分享他们对同性婚姻的支持——奥巴马最终成为第一位这样做的总统。	Public Sentiment	zh-CN	12.0
虽然在过去 15 年中，对同性婚姻的支持在几代人中都有所增长，但年龄差距仍然很大。	Quality of Life	zh-CN	10.0
例如，沉默一代（1928 年至 1945 年之间出生的人）中有 45% 的成年人允许同性恋者结婚，而千禧一代（1981 年至 1996 年之间出生的人）的这一比例为 74%。	Quality of Life	zh-CN	10.0
2017 年的盖洛普民意调查发现，十分之一的 LGBT 美国人 (10.2%) 在高等法院作出裁决前几个月 (7.9%) 与同性伴侣结婚。	Quality of Life	zh-CN	10.0
新民意调查于 10 月在中期选举之前进行，在最高法院 6 月推翻 Roe v. Wade 案的裁决后，对同性婚姻是否在全国范​​围内合法提出了一些疑问。堕胎法正在回归各州。	Quality of Life	zh-CN	10.0
皮尤研究中心提出这个问题是为了追踪公众对同性婚姻法律地位的看法。	Quality of Life	zh-CN	10.0
它要求各州尊重州外结婚证的有效性，包括同性和多种族伴侣关系。	Security and Defense	zh-CN	8.0
“追求幸福意味着你可以爱任何你想要的人，”他说，并补充道，“我很惊讶自由意志主义保守派不知何故认为我们应该同谋。	Security and Defense	zh-CN	8.0
它澄清宗教机构不需要执行同性婚姻，政府不能强迫他们保护一夫多妻制婚姻。	Security and Defense	zh-CN	8.0
众议院周二通过立法，在全国范围内将同性婚姻编纂成法典，并加强对婚姻平等的其他保护，这是对最高法院最近推翻长期存在的州堕胎权的裁决的直接回应。	Security and Defense	zh-CN	8.0
一方面，结婚的目的是为了保证生育和养育子女的顺利进行。	Quality of Life	zh-CN	10.0
