sentence	label_name	Language	label_ID
Ο γάμος ομοφυλόφιλων έχει θετικές οικονομικές επιπτώσεις, όπως αυξημένα εισοδήματα από Β. τουριστικές άδειες και άδειες γάμου και έξοδα που σχετίζονται με γάμους.	Economic	el	1.0
Οι πολέμιοι του γάμου ομοφύλων υποστηρίζουν ότι θα οδηγήσει σε αρνητικές οικονομικές συνέπειες, όπως η αποδυνάμωση των παραδοσιακών οικογενειακών δομών και συνακόλουθη κοινωνική αστάθεια.	Economic	el	1.0
Η νομιμοποίηση του γάμου μεταξύ ατόμων του ίδιου φύλου θα βοηθούσε τα ομόφυλα ζευγάρια να έχουν πρόσβαση στους ίδιους πόρους και οφέλη με τα ετεροφυλόφιλα ζευγάρια, όπως τα δικαιώματα νοσηλείας B. και τα δικαιώματα κληρονομιάς.	Capacity and Resources	el	2.0
Ορισμένοι πολέμιοι του γάμου μεταξύ ατόμων του ιδίου φύλου υποστηρίζουν ότι θα αποδυναμώσει την ικανότητα των κρατικών υπηρεσιών και ιδρυμάτων να αναγνωρίζουν και να αναγνωρίζουν τους γάμους ομοφυλόφιλων.	Capacity and Resources	el	2.0
Οι υποστηρικτές του γάμου μεταξύ ατόμων του ίδιου φύλου υποστηρίζουν ότι είναι θεμελιώδες ανθρώπινο δικαίωμα και ότι είναι ηθικά λάθος να αρνούμαστε στα ομόφυλα ζευγάρια το δικαίωμα να παντρευτούν.	Morality	el	3.0
Οι πολέμιοι του γάμου ομοφύλων συχνά βασίζουν τα επιχειρήματά τους σε θρησκευτικούς ή ηθικούς λόγους, υποστηρίζοντας ότι ο γάμος πρέπει να γίνεται μόνο μεταξύ ενός άνδρα και μιας γυναίκας.	Morality	el	3.0
Η νομιμοποίηση του γάμου μεταξύ ατόμων του ίδιου φύλου θεωρείται συχνά ζήτημα δικαιοσύνης και ισότητας, καθώς παρέχει στα ομόφυλα ζευγάρια την ίδια νομική αναγνώριση και οφέλη με τα ετεροφυλόφιλα ζευγάρια.	Fairness and Equality	el	4.0
Οι πολέμιοι του γάμου μεταξύ ατόμων του ίδιου φύλου υποστηρίζουν ότι δεν είναι ισότητα, επειδή τα ομόφυλα ζευγάρια επιτρέπεται να συνάπτουν καταχωρημένες συντροφικές σχέσεις ή σχέσεις κοινού φύλου, κάτι που τους παρέχει πολλά από τα ίδια νομικά δικαιώματα με τα παντρεμένα ζευγάρια.	Fairness and Equality	el	4.0
Το νομικό καθεστώς του γάμου ομοφυλόφιλων διαφέρει ανάλογα με τη δικαιοδοσία. ορισμένες χώρες και κράτη το νομιμοποιούν ενώ άλλες όχι. Προκάλεσε διαμάχη για θέματα όπως τα δικαιώματα των πολιτειών και ο ρόλος της ομοσπονδιακής κυβέρνησης στον ορισμό του γάμου.	Legality, Constitutionality, Jurisdiction	el	5.0
Οι πολέμιοι του γάμου ομοφύλων γενικά υποστηρίζουν ότι εναπόκειται στις πολιτείες να αποφασίσουν αν θα τον νομιμοποιήσουν ή όχι, ενώ οι υποστηρικτές γενικά υποστηρίζουν ότι είναι θέμα ομοσπονδιακών συνταγματικών δικαιωμάτων.	Legality, Constitutionality, Jurisdiction	el	5.0
Οι υποστηρικτές του γάμου ομοφύλων βλέπουν τη νομιμοποίηση του γάμου ομοφύλων ως ένα θετικό πολιτικό βήμα προς μεγαλύτερη ισότητα και ένταξη.	Policy Prescription and Evaluation	el	6.0
Οι πολέμιοι του γάμου ομοφύλων υποστηρίζουν ότι έχει αρνητικές κοινωνικές και πολιτιστικές συνέπειες και δεν προσφέρει βιώσιμη πολιτική λύση στα προβλήματα που αντιμετωπίζουν τα ομόφυλα ζευγάρια.	Policy Prescription and Evaluation	el	6.0
Δεν υπάρχουν εγγενείς ποινικές ή ποινικές συνέπειες στη νομιμοποίηση του γάμου μεταξύ ατόμων του ίδιου φύλου.	Crime and Punishment	el	7.0
Ωστόσο, οι πολέμιοι του γάμου ομοφύλων συχνά υποστηρίζουν ότι θα καταστρέψει τις παραδοσιακές οικογενειακές αξίες και τα ηθικά πρότυπα, τα οποία λένε ότι θα έχουν αρνητικές κοινωνικές συνέπειες.	Crime and Punishment	el	7.0
Η νομιμοποίηση του γάμου μεταξύ ατόμων του ίδιου φύλου δεν έχει εγγενείς συνέπειες για την ασφάλεια ή την ασφάλεια.	Security and Defense	el	8.0
Ωστόσο, ορισμένοι αντίπαλοι του γάμου ομοφύλων ισχυρίζονται ότι υπονομεύει τις παραδοσιακές οικογενειακές δομές, οι οποίες λένε ότι είναι απαραίτητες για ισχυρές κοινωνικές αξίες και εθνική άμυνα.	Security and Defense	el	8.0
Η νομιμοποίηση του γάμου μεταξύ ατόμων του ιδίου φύλου είχε θετικό αντίκτυπο στην υγεία και την ασφάλεια παρέχοντας στα ομόφυλα ζευγάρια πρόσβαση σε σημαντικά νομικά και ιατρικά οφέλη, όπως ασφάλιση υγείας και δικαιώματα επίσκεψης στο νοσοκομείο.	Health and Safety	el	9.0
Οι πολέμιοι του γάμου ομοφύλων υποστηρίζουν ότι μπορεί να οδηγήσει σε αρνητικές συνέπειες για την υγεία, όπως:	Health and Safety	el	9.0
Η νομιμοποίηση του γάμου μεταξύ ατόμων του ίδιου φύλου θα έχει θετικό αντίκτυπο στην ποιότητα ζωής των ομόφυλων ζευγαριών, παρέχοντάς τους μεγαλύτερη νομική αναγνώριση και πρόσβαση σε σημαντικά οφέλη και πόρους.	Quality of Life	el	10.0
Οι πολέμιοι του γάμου ομοφύλων συχνά υποστηρίζουν ότι διαταράσσει τις παραδοσιακές οικογενειακές δομές και αξίες, γεγονός που επηρεάζει αρνητικά την ποιότητα ζωής για τα άτομα και τις οικογένειες.	Quality of Life	el	10.0
Ο γάμος μεταξύ ομοφυλοφίλων μπορεί να θεωρηθεί ως αντανάκλαση της αλλαγής της πολιτισμικής στάσης απέναντι στα δικαιώματα και την αποδοχή των LGBTQ+.	Cultural Identity	el	11.0
Οι πολέμιοι του γάμου μεταξύ ατόμων του ίδιου φύλου συζητούν συχνά τη διατήρηση των παραδοσιακών πολιτιστικών αξιών και κανόνων.	Cultural Identity	el	11.0
Η κοινή γνώμη για τους γάμους ομοφύλων έχει αλλάξει δραματικά τα τελευταία χρόνια, με αυξανόμενη υποστήριξη για τη νομική αναγνώριση των σχέσεων μεταξύ ατόμων του ίδιου φύλου.	Public Sentiment	el	12.0
Ωστόσο, ορισμένοι πολέμιοι του γάμου ομοφύλων υποστηρίζουν ότι η κοινή γνώμη δεν πρέπει να επηρεάζει τις αποφάσεις πολιτικής και ότι ο γάμος πρέπει να ορίζεται μεταξύ ενός άνδρα και μιας γυναίκας.	Public Sentiment	el	12.0
Ο γάμος μεταξύ ομοφύλων είναι ένα άκρως πολιτικό ζήτημα, με διαφορετικά πολιτικά κόμματα και ομάδες συμφερόντων να λαμβάνουν διαφορετικές θέσεις σχετικά με αυτό το θέμα.	Political	el	13.0
Η νομιμοποίηση του γάμου ομοφύλων γίνεται συχνά πολιτικό ζήτημα κατά τη διάρκεια των εκλογών, καθώς οι υποψήφιοι σχολιάζουν μέσω των δικών τους πλατφορμών.	Political	el	13.0
Το νομικό καθεστώς του γάμου ομοφυλόφιλων μπορεί να επηρεάσει τη διεθνή θέση μιας χώρας, ιδίως όσον αφορά τη στάση της σε θέματα ανθρωπίνων δικαιωμάτων και LGBTQ+.	External Regulation and Reputation	el	14.0
Ορισμένοι πολέμιοι του γάμου ομοφύλων ισχυρίζονται ότι βλάπτει την εικόνα της χώρας και τις σχέσεις της με άλλες χώρες.	External Regulation and Reputation	el	14.0
Ο γάμος μεταξύ ατόμων του ιδίου φύλου είναι συνυφασμένος με πολλά άλλα ζητήματα, όπως η υιοθεσία και η επιμέλεια των παιδιών, οι διακρίσεις και τα εγκλήματα μίσους και οι ανισότητες στην υγεία.	Other	el	15.0
Η συζήτηση για τον γάμο μεταξύ ατόμων του ιδίου φύλου είναι πολύπλοκη και πολύπλευρη και συχνά περιλαμβάνει διαφορετικές ομάδες συμφερόντων και απόψεις.	Other	el	15.0
Η μετανάστευση έχει θετικές και αρνητικές επιπτώσεις στην οικονομία, ενώ συμβάλλει στην οικονομία μέσω της απασχόλησης και της κατανάλωσης, καταναλώνει και δημόσιους πόρους.	Economic	el	1.0
Ορισμένοι υποστηρίζουν ότι η μετανάστευση είναι απαραίτητη για την οικονομική ανάπτυξη, ειδικά σε τομείς που σπανίζουν εργατικό δυναμικό, ενώ άλλοι υποστηρίζουν ότι κάνει τους ντόπιους εργαζόμενους να χάσουν τις δουλειές τους.	Economic	el	1.0
Η μετανάστευση ασκεί πίεση στους δημόσιους πόρους όπως η υγεία, η εκπαίδευση και η στέγαση, ειδικά σε περιοχές με μεγάλο πληθυσμό μεταναστών.	Capacity and Resources	el	2.0
Ορισμένοι όμως υποστηρίζουν ότι οι μετανάστες φέρνουν επίσης δεξιότητες και ικανότητες που ωφελούν την κοινωνία και συμβάλλουν στην ανάπτυξη αυτών των πόρων.	Capacity and Resources	el	2.0
Η δεοντολογία της μετανάστευσης είναι ένα αμφιλεγόμενο ζήτημα, με κάποιους να υποστηρίζουν ότι είναι ηθική επιταγή η παροχή προστασίας και ευκαιριών σε όσους έχουν ανάγκη, ενώ άλλοι πιστεύουν ότι είναι ανήθικο να επιτρέπεται σε μετανάστες χωρίς έγγραφα να παραμείνουν στη χώρα.	Morality	el	3.0
Οι συζητήσεις για τη μετανάστευση συχνά περιστρέφονται γύρω από ζητήματα δικαιοσύνης και ισότητας. Ορισμένοι υποστηρίζουν ότι είναι άδικο να δίνουμε προτεραιότητα στις ανάγκες των μεταναστών έναντι των γηγενών πολιτών, ενώ άλλοι υποστηρίζουν ότι οι μετανάστες πρέπει να έχουν ίσες ευκαιρίες ανεξαρτήτως εθνικότητας.	Fairness and Equality	el	4.0
Η νομιμότητα της μετανάστευσης είναι ένα σύνθετο ζήτημα με διαφορετικούς νόμους και κανονισμούς που διέπουν διαφορετικούς τύπους μετανάστευσης και θεωρήσεων.	Legality, Constitutionality, Jurisdiction	el	5.0
Ορισμένοι πιστεύουν ότι η μεταναστευτική πολιτική είναι αντισυνταγματική ή άδικη, ενώ άλλοι πιστεύουν ότι είναι σημαντικό να επιβληθεί και να προστατευθεί η εθνική ασφάλεια.	Legality, Constitutionality, Jurisdiction	el	5.0
Η αποτελεσματικότητα των διάφορων πολιτικών και προγραμμάτων για τη μετανάστευση είναι μια συνεχής συζήτηση καθώς διαφορετικοί ενδιαφερόμενοι προτείνουν διαφορετικές λύσεις για τις προκλήσεις και τις ευκαιρίες μετανάστευσης.	Policy Prescription and Evaluation	el	6.0
Η αξιολόγηση είναι σημαντική για να διασφαλιστεί ότι οι πολιτικές και τα προγράμματα μετανάστευσης είναι αποτελεσματικά και δίκαια.	Policy Prescription and Evaluation	el	6.0
Η σχέση μεταξύ μετανάστευσης και εγκληματικότητας είναι αμφιλεγόμενη, με κάποιους να υποστηρίζουν ότι οι μετανάστες είναι πιο πιθανό να διαπράξουν εγκλήματα και να αποτελούν απειλή για τη δημόσια ασφάλεια, ενώ άλλοι υποστηρίζουν ότι οι μετανάστες είναι λιγότερο επιρρεπείς να διαπράξουν εγκλήματα από τους ντόπιους πολίτες.	Crime and Punishment	el	7.0
Η μετανάστευση έχει επιπτώσεις στην εθνική ασφάλεια και την εθνική ασφάλεια, ιδιαίτερα τον έλεγχο και τον έλεγχο των μεταναστών και την πρόληψη της εισόδου πιθανών απειλών.	Security and Defense	el	8.0
Ωστόσο, ορισμένοι υποστηρίζουν ότι οι υπερβολικά περιοριστικές πολιτικές μετανάστευσης μπορούν να βλάψουν τις σχέσεις με άλλες χώρες και να περιορίσουν τις ευκαιρίες για συνεργασία και καινοτομία.	Security and Defense	el	8.0
Η μετανάστευση έχει επιπτώσεις στη δημόσια υγεία και ασφάλεια, ιδίως όσον αφορά τη διάδοση ασθενειών και την πρόσβαση στην υγειονομική περίθαλψη.	Health and Safety	el	9.0
Ωστόσο, ορισμένοι υποστηρίζουν ότι η παροχή υγειονομικής περίθαλψης και κοινωνικών υπηρεσιών μπορεί να βελτιώσει τα συνολικά αποτελέσματα της δημόσιας υγείας και να μειώσει την πίεση στις υπηρεσίες έκτακτης ανάγκης.	Health and Safety	el	9.0
Η μετανάστευση μπορεί να έχει θετικές και αρνητικές επιπτώσεις στην ποιότητα ζωής τόσο των μεταναστών όσο και των γηγενών πολιτών, ανάλογα με παράγοντες όπως οι οικονομικές συνθήκες, η κοινωνική ένταξη και η πολιτιστική ταυτότητα.	Quality of Life	el	10.0
Κάποιοι υποστηρίζουν ότι η μετανάστευση προωθεί την ποικιλομορφία και τις πολιτιστικές ανταλλαγές, ενώ άλλοι πιστεύουν ότι έχει οδηγήσει σε κοινωνικό και οικονομικό διχασμό.	Quality of Life	el	10.0
Η μετανάστευση έχει αντίκτυπο στην πολιτιστική ταυτότητα, ιδίως όσον αφορά τη γλώσσα, την παράδοση και τις αξίες.	Cultural Identity	el	11.0
Κάποιοι υποστηρίζουν ότι η μετανάστευση μπορεί να εμπλουτίσει και να διαφοροποιήσει τις πολιτιστικές εμπειρίες, ενώ άλλοι υποστηρίζουν ότι μπορεί να οδηγήσει σε πτώση της εθνικής ταυτότητας και της κοινωνικής συνοχής.	Cultural Identity	el	11.0
Η κοινή γνώμη για τη μετανάστευση έχει πολωθεί, με ορισμένους να εκφράζουν την υποστήριξη για περισσότερη μετανάστευση, ενώ άλλοι να απαιτούν περισσότερο έλεγχο και περιορισμούς.	Public Sentiment	el	12.0
Ο τρόπος με τον οποίο τα μέσα ενημέρωσης και οι πολιτικοί απεικονίζουν τους μετανάστες μπορεί να επηρεάσει την κοινή γνώμη και τις πολιτικές αποφάσεις.	Public Sentiment	el	12.0
Η μετανάστευση είναι ένα εξαιρετικά πολιτικό ζήτημα, με διαφορετικά πολιτικά κόμματα και ομάδες συμφερόντων να λαμβάνουν διαφορετικές θέσεις σχετικά με αυτό το θέμα.	Political	el	13.0
Η συζήτηση για τη μετανάστευση γίνεται συχνά πολιτικό ζήτημα κατά τη διάρκεια των εκλογών, με τους υποψηφίους να λαμβάνουν θέσεις για το θέμα στις δικές τους πλατφόρμες.	Political	el	13.0
Ο τρόπος με τον οποίο μια χώρα χειρίζεται τη μετανάστευση μπορεί να επηρεάσει τη φήμη και τις σχέσεις της με άλλες χώρες, ειδικά όταν πρόκειται για ανθρώπινα δικαιώματα και το διεθνές δίκαιο.	External Regulation and Reputation	el	14.0
Τα μεταναστευτικά πρότυπα επηρεάζονται επίσης από τις εξωτερικές πιέσεις και τους κανόνες των διεθνών οργανισμών και συνθηκών.	External Regulation and Reputation	el	14.0
Άλλα ζητήματα που σχετίζονται με τη μετανάστευση περιλαμβάνουν τον αντίκτυπο στη δυναμική της οικογένειας, τον ρόλο των μεταναστών στη διαμόρφωση των δημογραφικών τάσεων και την πολιτιστική ανταλλαγή και την ένταξη των μεταναστών στην κοινωνία.	Other	el	15.0
Τα ζητήματα αυτά έχουν σημαντικό αντίκτυπο στην κοινωνική, οικονομική και πολιτική δυναμική της χώρας.	Other	el	15.0
Ο γάμος ομοφυλόφιλων μπορεί να έχει θετικό οικονομικό αντίκτυπο με την τόνωση των τοπικών επιχειρήσεων και του τουρισμού και την αύξηση των κρατικών φορολογικών εσόδων.	Economic	el	1.0
Οι αντίπαλοι ισχυρίζονται ότι ο γάμος μεταξύ ατόμων του ίδιου φύλου διαταράσσει τον παραδοσιακό γάμο και τις οικογενειακές δομές και επηρεάζει αρνητικά την οικονομία.	Economic	el	1.0
Η νομιμοποίηση του γάμου μεταξύ ατόμων του ίδιου φύλου θα αυξήσει την πρόσβαση των ομόφυλων ζευγαριών σε πόρους και οφέλη, όπως η υγειονομική περίθαλψη και τα γονικά δικαιώματα.	Capacity and Resources	el	2.0
Οι επικριτές υποστηρίζουν ότι ο γάμος μεταξύ ατόμων του ιδίου φύλου απαιτεί πόρους και ικανότητα, επειδή απαιτεί αλλαγές στα νομικά πλαίσια και τους θεσμούς.	Capacity and Resources	el	2.0
Οι υποστηρικτές του γάμου μεταξύ ατόμων του ίδιου φύλου υποστηρίζουν ότι είναι ηθική επιταγή να αναγνωρίζονται τα ίσα δικαιώματα και η αξιοπρέπεια όλων των ανθρώπων, ανεξάρτητα από τον σεξουαλικό τους προσανατολισμό.	Morality	el	3.0
Οι αντίπαλοι υποστηρίζουν ότι ο γάμος μεταξύ ατόμων του ιδίου φύλου είναι ανήθικος και παραβιάζει τις παραδοσιακές θρησκευτικές και πολιτιστικές αξίες.	Morality	el	3.0
Ο γάμος μεταξύ ομοφυλοφίλων θεωρείται σημαντικό ζήτημα δικαιοσύνης και ισότητας για τα άτομα LGBTQ+, καθώς προσφέρει τα ίδια νομικά δικαιώματα και προστασία με τα ετεροφυλόφιλα ζευγάρια.	Fairness and Equality	el	4.0
Οι επικριτές υποστηρίζουν ότι ο γάμος μεταξύ ατόμων του ιδίου φύλου δεν είναι ζήτημα ισότητας, επειδή απαιτεί έναν επαναπροσδιορισμό του παραδοσιακού ορισμού του γάμου.	Fairness and Equality	el	4.0
Η νομιμότητα του γάμου ομοφύλων έχει συζητηθεί με δικαστήρια και κυβερνήσεις που διαφέρουν ως προς τη συνταγματική ερμηνεία και τις δικαστικές απόψεις.	Legality, Constitutionality, Jurisdiction	el	5.0
Οι αντίπαλοι υποστηρίζουν ότι ο γάμος ομοφυλόφιλων δεν πρέπει να νομιμοποιηθεί επειδή ούτε το Σύνταγμα ούτε το προηγούμενο επιβάλλουν ρητά τους γάμους ομοφυλόφιλων.	Legality, Constitutionality, Jurisdiction	el	5.0
Οι ρυθμίσεις πολιτικής για τον γάμο ομοφύλων ποικίλλουν ανάλογα με πολιτικούς και πολιτισμικούς παράγοντες. ορισμένες χώρες το νομιμοποιούν ενώ άλλες συνεχίζουν να το απαγορεύουν.	Policy Prescription and Evaluation	el	6.0
Η αξιολόγηση του κοινωνικού και προσωπικού αντίκτυπου του γάμου μεταξύ ατόμων του ιδίου φύλου είναι μια συνεχής διαδικασία, με την έρευνα να δείχνει τόσο θετικά όσο και αρνητικά αποτελέσματα.	Policy Prescription and Evaluation	el	6.0
Ορισμένες δικαιοδοσίες ποινικοποιούν τους γάμους ομοφυλόφιλων και τα άτομα αντιμετωπίζουν νομικές κυρώσεις ή κοινωνικές διώξεις για σχέσεις μεταξύ ατόμων του ίδιου φύλου.	Crime and Punishment	el	7.0
Οι προσπάθειες νομιμοποίησης του γάμου μεταξύ ατόμων του ίδιου φύλου θεωρούνται συχνά ως ένας τρόπος για τον τερματισμό των διακρίσεων και των τιμωριών που βασίζονται στον σεξουαλικό προσανατολισμό.	Crime and Punishment	el	7.0
Ο γάμος ομοφυλόφιλων έχει χρησιμοποιηθεί ως εργαλείο για την προώθηση της εθνικής ασφάλειας και της ατζέντας για τα ανθρώπινα δικαιώματα, ιδιαίτερα στο πλαίσιο των διεθνών σχέσεων και της διπλωματίας.	Security and Defense	el	8.0
Οι επικριτές πιστεύουν ότι ο γάμος μεταξύ ατόμων του ιδίου φύλου υπονομεύει τον θεσμό του γάμου και της οικογένειας και επηρεάζει αρνητικά την εθνική ασφάλεια και την κοινωνική σταθερότητα.	Security and Defense	el	8.0
Η νομιμοποίηση του γάμου μεταξύ ατόμων του ιδίου φύλου μπορεί να βελτιώσει την υγεία και την ασφάλεια των LGBTQ+ ατόμων παρέχοντάς τους πρόσβαση σε υγειονομική περίθαλψη, ασφάλιση και νομική προστασία.	Health and Safety	el	9.0
Οι αντίπαλοι ισχυρίζονται ότι ο γάμος μεταξύ ατόμων του ιδίου φύλου είναι επιβλαβής για την ατομική και δημόσια υγεία, οδηγώντας σε εξάπλωση ασθενειών και άλλες αρνητικές συνέπειες.	Health and Safety	el	9.0
Δεδομένης της νομικής και κοινωνικής αποδοχής LGBTQ+, ο γάμος ομοφυλόφιλων θεωρείται σημαντικός παράγοντας για τη βελτίωση της ποιότητας ζωής για τα άτομα LGBTQ+.	Quality of Life	el	10.0
Οι επικριτές υποστηρίζουν ότι ο γάμος μεταξύ ατόμων του ίδιου φύλου υπονομεύει τις παραδοσιακές αξίες και δομές, επηρεάζοντας αρνητικά την ποιότητα ζωής των ατόμων και της κοινωνίας στο σύνολό της.	Quality of Life	el	10.0
Ο γάμος ομοφύλων θεωρείται βασικό ζήτημα της πολιτιστικής ταυτότητας LGBTQ+, καθώς αντιπροσωπεύει μια θεμελιώδη αναγνώριση της ύπαρξης και των δικαιωμάτων τους στην κοινωνία.	Cultural Identity	el	11.0
Οι αντίπαλοι υποστηρίζουν ότι ο γάμος μεταξύ ατόμων του ίδιου φύλου απειλεί τις παραδοσιακές πολιτιστικές ταυτότητες και αξίες και μπορεί να οδηγήσει σε κοινωνική και ηθική παρακμή.	Cultural Identity	el	11.0
Με την πάροδο του χρόνου, η κοινή γνώμη για τους γάμους ομοφυλόφιλων έχει επίσης αναπτυχθεί και όλο και περισσότερες χώρες και περιοχές αποδέχονται και υποστηρίζουν τους γάμους ομοφυλόφιλων.	Public Sentiment	el	12.0
Η προσπάθεια νομιμοποίησης του γάμου μεταξύ ατόμων του ιδίου φύλου συχνά καθοδηγείται από το δημόσιο αίσθημα, με πολιτικούς και οργανισμούς να ανταποκρίνονται στις μεταβαλλόμενες στάσεις και ιδέες.	Public Sentiment	el	12.0
Το ζήτημα του γάμου μεταξύ ατόμων του ίδιου φύλου είναι συχνά πολιτικό, με πολιτικά κόμματα και πολιτικούς να παίρνουν διαφορετικές θέσεις ανάλογα με τις αξίες και τις ιδεολογίες τους.	Political	el	13.0
Η νομιμοποίηση του γάμου μεταξύ ατόμων του ιδίου φύλου έχει γίνει ένα σημαντικό πολιτικό ζήτημα για τους ακτιβιστές των δικαιωμάτων LGBTQ+, οι οποίοι το βλέπουν ως έναν τρόπο για την επίτευξη μεγαλύτερης κοινωνικής και νομικής ισότητας.	Political	el	13.0
Ο γάμος ομοφύλων θεωρείται συχνά ως μέτρο της δέσμευσης της χώρας στην κοινωνική πρόοδο και τα ανθρώπινα δικαιώματα, αλλά διεθνείς ομάδες και σύμμαχοι πιέζουν την κυβέρνηση να τον νομιμοποιήσει.	External Regulation and Reputation	el	14.0
Οι αντίπαλοι υποστηρίζουν ότι η εξωτερική πίεση για τη νομιμοποίηση του γάμου ομοφύλων παραβιάζει την εθνική κυριαρχία και τις πολιτιστικές αξίες.	External Regulation and Reputation	el	14.0
Ο γάμος μεταξύ ατόμων του ίδιου φύλου είναι ένα εξαιρετικά αμφιλεγόμενο και συναισθηματικό ζήτημα όπου άτομα και ομάδες και στις δύο πλευρές αγωνίζονται για τις πεποιθήσεις και τις αξίες τους.	Other	el	15.0
Η συζήτηση για τον γάμο μεταξύ ατόμων του ιδίου φύλου είναι πολύπλοκη και πολύπλευρη και αντανακλά ευρύτερες κοινωνικές και πολιτισμικές εντάσεις γύρω από την ταυτότητα, τις αξίες και την εξουσία.	Other	el	15.0
Η μετανάστευση έχει τόσο θετικά όσο και αρνητικά οικονομικά αποτελέσματα, με κάποιους να υποστηρίζουν ότι φέρνει πολύτιμη εργασία και δεξιότητες, ενώ άλλοι υποστηρίζουν ότι μειώνει τους μισθούς και βλάπτει τις κοινωνικές υπηρεσίες.	Economic	el	1.0
Πολλές εταιρείες βασίζονται σε μετανάστες εργάτες, ειδικά σε βιομηχανίες όπως η γεωργία, η φιλοξενία και οι κατασκευές.	Economic	el	1.0
Η μετανάστευση ασκεί πίεση στις υποδομές και τους πόρους μιας χώρας, όπως η στέγαση, οι μεταφορές και η υγειονομική περίθαλψη, ειδικά σε περιοχές με υψηλή ζήτηση για υπηρεσίες.	Capacity and Resources	el	2.0
Πολλές χώρες περιορίζουν τον αριθμό των μεταναστών που μπορούν να δεχτούν με βάση τους πόρους και την ικανότητά τους να παρέχουν υποστήριξη.	Capacity and Resources	el	2.0
Ορισμένοι βλέπουν τη μετανάστευση ως ηθική υποχρέωση να βοηθήσουν όσους έχουν ανάγκη, ειδικά τους πρόσφυγες που ξεφεύγουν από τη βία ή τη δίωξη στη χώρα τους.	Morality	el	3.0
Άλλοι υποστηρίζουν ότι είναι ανήθικο να επιτρέπεται στους μετανάστες να εισέρχονται παράνομα ή να εκμεταλλεύονται μετανάστες εργάτες.	Morality	el	3.0
Πολλοί υποστηρίζουν ότι η μεταναστευτική πολιτική πρέπει να βασίζεται στις αρχές της δικαιοσύνης και της ισότητας και ότι οι μετανάστες πρέπει να αντιμετωπίζονται με αξιοπρέπεια και σεβασμό.	Fairness and Equality	el	4.0
Άλλοι υποστηρίζουν ότι είναι άδικο και άδικο να δίνουμε προτεραιότητα στους μετανάστες έναντι των πολιτών.	Fairness and Equality	el	4.0
Η μεταναστευτική πολιτική αντιμετωπίζει νομικές και συνταγματικές προκλήσεις, ιδίως όσον αφορά την υπηκοότητα, την απέλαση και το άσυλο.	Legality, Constitutionality, Jurisdiction	el	5.0
Πολλές χώρες έχουν διαφορές δικαιοδοσίας, με τις τοπικές, πολιτειακές και ομοσπονδιακές κυβερνήσεις να παίζουν ρόλο στη μεταναστευτική πολιτική.	Legality, Constitutionality, Jurisdiction	el	5.0
Η μεταναστευτική πολιτική συχνά καθορίζεται από τη διαμόρφωση και την αξιολόγηση πολιτικής, όπου οι ειδικοί και οι υπεύθυνοι χάραξης πολιτικής σταθμίζουν το κόστος και τα οφέλη των διαφορετικών προσεγγίσεων.	Policy Prescription and Evaluation	el	6.0
Ορισμένοι υποστηρίζουν ότι η στρατηγική πρέπει να βασίζεται σε στοιχεία και να βασίζεται σε δεδομένα, ενώ άλλοι τονίζουν θεωρητικούς ή πολιτικούς λόγους.	Policy Prescription and Evaluation	el	6.0
Η πολιτική μετανάστευσης συνδέεται συχνά με ζητήματα εγκλήματος και τιμωρίας, και ορισμένοι υποστηρίζουν ότι οι μετανάστες είναι πιο πιθανό να διαπράξουν εγκλήματα και θα πρέπει να υπόκεινται σε αυστηρότερα μέτρα επιβολής.	Crime and Punishment	el	7.0
Άλλοι υποστηρίζουν ότι οι μετανάστες στοχοποιούνται άδικα και ότι οι πολιτικές πρέπει να επικεντρωθούν στη μείωση της εγκληματικότητας και στη βελτίωση της δημόσιας ασφάλειας για όλους τους κατοίκους.	Crime and Punishment	el	7.0
Η μεταναστευτική πολιτική επηρεάζει την ασφάλεια και την άμυνα της χώρας, ιδίως όσον αφορά τον έλεγχο των συνόρων και τα ζητήματα εθνικής ταυτότητας.	Security and Defense	el	8.0
Ορισμένοι θεωρούν τη μετανάστευση ως απειλή για την εθνική ασφάλεια, ενώ άλλοι θεωρούν ότι είναι απαραίτητη για τη διατήρηση μιας πλουραλιστικής και πολυπολιτισμικής κοινωνίας.	Security and Defense	el	8.0
Η μεταναστευτική πολιτική έχει επιπτώσεις στη δημόσια υγεία και ασφάλεια, ιδίως όσον αφορά τον έλεγχο των ασθενειών και τα θέματα αντιμετώπισης καταστάσεων έκτακτης ανάγκης.	Health and Safety	el	9.0
Ορισμένοι υποστηρίζουν ότι η μεταναστευτική πολιτική πρέπει να δίνει προτεραιότητα στη δημόσια υγεία και ασφάλεια, ενώ άλλοι υποστηρίζουν ότι η πολιτική πρέπει να δίνει προτεραιότητα στις ανάγκες των μεταναστών και των προσφύγων.	Health and Safety	el	9.0
Οι μεταναστευτικές πολιτικές επηρεάζουν την ποιότητα ζωής των μεταναστών και των πολιτών, ιδίως όσον αφορά την κοινωνική συνοχή, την εκπαίδευση και την απασχόληση.	Quality of Life	el	10.0
Κάποιοι υποστηρίζουν ότι η μετανάστευση βελτιώνει την ποιότητα ζωής παρέχοντας διαφορετικές προοπτικές και δεξιότητες, ενώ άλλοι υποστηρίζουν ότι δημιουργεί κοινωνική ένταση και συγκρούσεις.	Quality of Life	el	10.0
Η μεταναστευτική πολιτική συνδέεται συχνά με ζητήματα πολιτιστικής ταυτότητας και ορισμένοι θεωρούν τη μετανάστευση ως απειλή για την εθνική ταυτότητα και τις πολιτιστικές παραδόσεις.	Cultural Identity	el	11.0
Άλλοι υποστηρίζουν ότι οι πολιτιστικές ταυτότητες εξελίσσονται συνεχώς και ότι η μετανάστευση μπορεί να εμπλουτίσει και να διαφοροποιήσει την πολιτιστική έκφραση.	Cultural Identity	el	11.0
Η πολιτική μετανάστευσης καθορίζεται συχνά από το δημόσιο αίσθημα και τη στάση απέναντι στη μετανάστευση, με κάποιους να υποστηρίζουν αυστηρότερες κυρώσεις και άλλους να υποστηρίζουν ευρύτερες πολιτικές.	Public Sentiment	el	12.0
Το δημόσιο αίσθημα επηρεάζεται από πολλούς παράγοντες, όπως η κάλυψη από τα μέσα ενημέρωσης, η πολιτική ρητορική και η προσωπική εμπειρία.	Public Sentiment	el	12.0
Η μεταναστευτική πολιτική συχνά επηρεάζεται από πολιτικές απόψεις, με διαφορετικά πολιτικά κόμματα και ομάδες συμφερόντων να λαμβάνουν διαφορετικές θέσεις ανάλογα με τις αξίες και τις ιδεολογίες τους.	Political	el	13.0
Η μεταναστευτική πολιτική μπορεί να είναι ένα ξεχωριστό πολιτικό ζήτημα, το οποίο οι πολιτικοί χρησιμοποιούν για να κινητοποιήσουν τη βάση τους και να απευθύνουν έκκληση σε διαφορετικούς δημογραφικούς ψηφοφόρους.	Political	el	13.0
Οι μεταναστευτικές πολιτικές μπορούν να επηρεάσουν τον εξωτερικό έλεγχο και τη φήμη μιας χώρας, ιδιαίτερα σε θέματα ανθρωπίνων δικαιωμάτων και διεθνούς δικαίου.	External Regulation and Reputation	el	14.0
Κάποιοι υποστηρίζουν ότι η μετανάστευση απειλεί την πολιτιστική ταυτότητα μιας χώρας επειδή εισάγει νέα ήθη και δοξασίες. Άλλοι, όμως, υποστηρίζουν ότι η διαφορετικότητα εμπλουτίζει τον πολιτισμό μιας κοινωνίας και πρέπει να γιορτάζεται.	Cultural Identity	el	11.0
Είναι σημαντικό οι μετανάστες να κατανοούν και να σέβονται την πολιτιστική ταυτότητα των χωρών στις οποίες πηγαίνουν, καθώς και να διατηρούν και να μοιράζονται τις μοναδικές πολιτιστικές παραδόσεις τους.	Cultural Identity	el	11.0
Η αντίληψη του κοινού για τη μετανάστευση ποικίλλει ανάλογα με την τοποθεσία και το πλαίσιο. Σε ορισμένες περιοχές, οι μετανάστες είναι ευπρόσδεκτοι και εκτιμώνται για τις υπηρεσίες που παρέχουν στην κοινότητα, ενώ σε άλλες περιοχές οι άνθρωποι μπορεί να φοβούνται ή να δυσανασχετούν με τους μετανάστες αφαιρώντας τις δουλειές ή τους πόρους τους.	Public Sentiment	el	12.0
Τα μέσα ενημέρωσης παίζουν ρόλο στη διαμόρφωση της στάσης του κοινού απέναντι στους μετανάστες, με συγκλονιστικές ιστορίες για εγκλήματα μεταναστών που προωθούν αρνητικές στάσεις απέναντι στους μετανάστες.	Public Sentiment	el	12.0
Η μεταναστευτική πολιτική έχει συχνά πολιτικά κίνητρα, με τους πολιτικούς να προσπαθούν να κερδίσουν ψήφους απευθύνοντας έκκληση στους υποστηρικτές τους ή τηρώντας σκληρή στάση για τη μετανάστευση.	Political	el	13.0
Οι διεθνείς σχέσεις μπορούν επίσης να επηρεάσουν τη μεταναστευτική πολιτική μιας χώρας, με διπλωματικές εκτιμήσεις και συμφωνίες που επηρεάζουν τη ροή των μεταναστών.	Political	el	13.0
Διεθνείς οργανισμοί και συμφωνίες όπως τα Ηνωμένα Έθνη και η Ευρωπαϊκή Ένωση διαδραματίζουν ρόλο στη ρύθμιση και τη διαμόρφωση της μεταναστευτικής πολιτικής.	External Regulation and Reputation	el	14.0
Η φήμη μιας χώρας ως φιλόξενου ή εχθρικού τόπου για τους μετανάστες έχει σημαντικές οικονομικές και πολιτικές προεκτάσεις που επηρεάζουν τον τουρισμό, το εμπόριο και τις διπλωματικές σχέσεις.	External Regulation and Reputation	el	14.0
Η μετανάστευση μπορεί να έχει τόσο θετικές όσο και αρνητικές οικονομικές επιπτώσεις σε μια χώρα, για παράδειγμα παρέχοντας φθηνό εργατικό δυναμικό και αυξάνοντας τον ανταγωνισμό για θέσεις εργασίας και πόρους.	Economic	el	1.0
Η ικανότητα μιας χώρας να δέχεται και να υποστηρίζει μετανάστες περιορίζεται από την ικανότητα στέγασης, εκπαίδευσης, υγειονομικής περίθαλψης και άλλους πόρους.	Capacity and Resources	el	2.0
Οι ηθικοί προβληματισμοί σχετικά με τη μετανάστευση περιλαμβάνουν ερωτήσεις σχετικά με τα δικαιώματα των μεταναστών και τις ευθύνες των χωρών υποδοχής απέναντί ​​τους.	Morality	el	3.0
Η μεταναστευτική πολιτική πρέπει να είναι δίκαιη και δίκαιη, παρέχοντας δίκαιες και ίσες ευκαιρίες για όλους τους μετανάστες.	Fairness and Equality	el	4.0
Οι νόμοι και οι πολιτικές για τη μετανάστευση πρέπει να συμμορφώνονται με τις νομικές και συνταγματικές αρχές και είναι ευθύνη των κυβερνήσεων να τις επιβάλλουν.	Legality, Constitutionality, Jurisdiction	el	5.0
Η αποτελεσματική πολιτική μετανάστευσης απαιτεί προσεκτική εξέταση και εξέταση των στόχων, των επιπτώσεων και των στρατηγικών εφαρμογής.	Policy Prescription and Evaluation	el	6.0
Η μετανάστευση μπορεί να συσχετιστεί με εγκλήματα και ποινικά θέματα, συμπεριλαμβανομένης της ασφάλειας των συνόρων και των εγκληματικών δραστηριοτήτων που σχετίζονται με τη μετανάστευση.	Crime and Punishment	el	7.0
Η μεταναστευτική πολιτική έχει επιπτώσεις στην εθνική ασφάλεια και άμυνα, συμπεριλαμβανομένων πιθανών απειλών από τρομοκρατικές ομάδες και γεωπολιτικών συγκρούσεων.	Security and Defense	el	8.0
Η υγεία και η ασφάλεια των μεταναστών και των κοινοτήτων υποδοχής θα πρέπει να λαμβάνονται υπόψη στο πλαίσιο της μεταναστευτικής πολιτικής, συμπεριλαμβανομένων ζητημάτων όπως ο έλεγχος των ασθενειών και η υγιεινή.	Health and Safety	el	9.0
Η μετανάστευση επηρεάζει την ποιότητα ζωής τόσο των κοινοτήτων μεταναστών όσο και των κοινοτήτων υποδοχής, επηρεάζοντας την κοινωνική συνοχή, τις δημόσιες υπηρεσίες και την πολιτιστική ένταξη.	Quality of Life	el	10.0
Η μετανάστευση διαμορφώνει την πολιτιστική ταυτότητα των χωρών και των λαών τους, με θετικές και αρνητικές επιπτώσεις στη διαφορετικότητα και την κοινωνική συνοχή.	Cultural Identity	el	11.0
Οι στάσεις και οι αντιλήψεις του κοινού για τη μετανάστευση έχουν σημαντικές πολιτικές και κοινωνικές συνέπειες.	Public Sentiment	el	12.0
Η μεταναστευτική πολιτική συχνά επηρεάζεται από πολιτικούς προβληματισμούς όπως η εκλογική στρατηγική και η κομματική ιδεολογία.	Political	el	13.0
Οι διεθνείς οργανισμοί και οι συνθήκες διαδραματίζουν ρόλο στη διαμόρφωση και τη ρύθμιση της μεταναστευτικής πολιτικής, η οποία επηρεάζει τη φήμη και την παγκόσμια θέση μιας χώρας.	External Regulation and Reputation	el	14.0
Ο γάμος μεταξύ ομοφυλοφίλων είναι ηθικό και ηθικό ζήτημα και αποτελεί διάκριση και άδικο να αρνείται κανείς το δικαίωμα να παντρευτεί λόγω του σεξουαλικού τους προσανατολισμού.	Morality	el	3.0
Όλοι οι άνθρωποι, ανεξάρτητα από τον σεξουαλικό τους προσανατολισμό, θα πρέπει να έχουν το δικαίωμα να παντρεύονται με τα ίδια νομικά δικαιώματα και προστασία με τα ετεροφυλόφιλα ζευγάρια.	Fairness and Equality	el	4.0
Είναι άδικο και ανήθικο να στερούνται οι άνθρωποι το δικαίωμά τους να παντρεύονται λόγω του σεξουαλικού τους προσανατολισμού.	Morality	el	3.0
Όλοι οι άνθρωποι, ανεξάρτητα από τον σεξουαλικό τους προσανατολισμό, θα πρέπει να έχουν το δικαίωμα να παντρεύονται με τα ίδια νομικά δικαιώματα και προστασία με τα ετεροφυλόφιλα ζευγάρια.	Fairness and Equality	el	4.0
Η αποδοχή και η στάση απέναντι στον γάμο ομοφύλων έχουν αλλάξει με την πάροδο του χρόνου σε πολλά μέρη του κόσμου, αλλά πρέπει να ξεπεραστούν σημαντικά πολιτιστικά και κοινωνικά εμπόδια.	Public Sentiment	el	12.0
Οι πολιτικές και οι νόμοι για τους γάμους ομοφυλόφιλων έχουν σημαντικό αντίκτυπο στην κοινωνία και είναι σημαντικό να αξιολογηθεί ο αντίκτυπός τους και να γίνουν οι απαραίτητες αλλαγές για τη διασφάλιση της δικαιοσύνης και της ισότητας.	Policy Prescription and Evaluation	el	6.0
Η νομιμοποίηση του γάμου μεταξύ ατόμων του ιδίου φύλου έχει οικονομικά οφέλη, καθώς τονώνει τον τουρισμό και δημιουργεί νέες ευκαιρίες εργασίας στον κλάδο των γάμων.	Economic	el	1.0
Ενώ ο γάμος ομοφυλόφιλων μπορεί να αμφισβητήσει τις παραδοσιακές ιδέες για τους ρόλους των φύλων και τους κοινωνικούς κανόνες, ορισμένοι πιστεύουν ότι βοηθά στην προώθηση μιας πιο διαφοροποιημένης και αποδεκτής πολιτιστικής ταυτότητας.	Cultural Identity	el	11.0
Η άρνηση του δικαιώματος των ομόφυλων ζευγαριών να παντρεύονται επηρεάζει αρνητικά την υγεία και την ευημερία τους, καθώς υφίστανται διακρίσεις και δεν έχουν πρόσβαση σε σημαντικές νομικές και οικονομικές προστασίες.	Health and Safety	el	9.0
Η συζήτηση για τους γάμους ομοφυλόφιλων είναι ένα σημαντικό πολιτικό ζήτημα σε πολλές χώρες όπου τα πολιτικά κόμματα και οι πολιτικοί λαμβάνουν διαφορετικές θέσεις ανάλογα με τις πεποιθήσεις τους και τις απόψεις των ψηφοφόρων.	Political	el	13.0
Η νομιμοποίηση του γάμου μεταξύ ατόμων του ιδίου φύλου είναι ένα σημαντικό βήμα προς την ισότητα για την LGBTQ+ κοινότητα και διασφαλίζει ότι έχουν τα ίδια δικαιώματα και ευκαιρίες με τα ετεροφυλόφιλα ζευγάρια.	Fairness and Equality	el	4.0
Για πολλούς, ο γάμος των ομοφυλοφίλων είναι ένα ηθικό ζήτημα, κάποιοι λένε ότι έρχεται σε αντίθεση με τις παραδοσιακές αξίες, ενώ άλλοι επιμένουν να γιορτάζουν την αγάπη και τη συντροφικότητα, ανεξαρτήτως φύλου.	Morality	el	3.0
Η άρνηση του δικαιώματος γάμου στα ομόφυλα ζευγάρια αποτελεί σαφή παραβίαση θεμελιωδών ανθρωπίνων δικαιωμάτων όπως η ισότητα και η μη διάκριση.	Fairness and Equality	el	4.0
Ο γάμος ομοφυλόφιλων παρέχει στα ζευγάρια σημαντικά οφέλη για την υγεία, όπως: Β. Ιατρικές παροχές, ασφαλιστική κάλυψη και πρόσβαση σε ιατρική περίθαλψη που είναι απαραίτητες σε περίπτωση ασθένειας ή έκτακτης ανάγκης.	Health and Safety	el	9.0
Ένας αξιωματούχος που γνωρίζει το προσχέδιο προϋπολογισμού έδωσε λεπτομέρειες για το αίτημα χρηματοδότησης προτού ο Πρόεδρος Μπάιντεν ανακοινώσει το σχέδιο τη Δευτέρα, υπό τον όρο της ανωνυμίας.	Capacity and Resources	el	2.0
Το ICE θα συνεχίσει να παρακολουθεί μεμονωμένες εγκαταστάσεις κράτησης για να διασφαλίσει ότι οι συνθήκες είναι ευνοϊκές σε συνεργασία με την ERO, την OPR και άλλους ρυθμιστικούς φορείς εντός του Υπουργείου Εσωτερικής Ασφάλειας.	Capacity and Resources	el	2.0
Η HSI συνεργάστηκε με το FBI για να πείσει το Υπουργείο Δικαιοσύνης να απαγγείλει κατηγορίες εναντίον των δύο συνωμότων του εγκλήματος.	Capacity and Resources	el	2.0
Συντονίζει τη διαχείριση κράτησης με 25 επιτόπια γραφεία του ERO για να παρέχει ένα ασφαλές περιβάλλον για μη πολίτες υπό κράτηση στο ICE μέσω της συμμόρφωσης με τις εγκαταστάσεις, της επιτόπιας παρακολούθησης και της αγοράς εγκαταστάσεων κράτησης.	Capacity and Resources	el	2.0
Το Γραφείο Επιτόπου 25 ERO διευκολύνει την υλικοτεχνική και επιχειρησιακή υποστήριξη επιχειρήσεων φοροδιαφυγής αναπτύσσοντας, εφαρμόζοντας και παρακολουθώντας σχέδια και διαδικασίες που υποστηρίζουν αποστολές Σχεδίου Δράσης Αποφυγής σε όλη τη χώρα.	Capacity and Resources	el	2.0
Αυτά τα κέντρα χρησιμοποιούν τεχνικές δεξιότητες, αναλυτικά εργαλεία και εμπειρογνωμοσύνη από την επιβολή του νόμου για να δημιουργήσουν συμβουλές απέλασης βάσει πληροφοριών για μη πολίτες.	Capacity and Resources	el	2.0
Μέσω συλλογής δεδομένων, ανάλυσης και βελτιώσεων τεχνολογίας και διαδικασιών, η LESA παρέχει εργαλεία, έρευνα και συστάσεις για την υποστήριξη της λήψης αποφάσεων και του σχεδιασμού του ICE.	Capacity and Resources	el	2.0
Σε συνεργασία με διυπηρεσιακά και διυπηρεσιακά ενδιαφερόμενα μέρη, ξένες πρεσβείες και προξενεία και διεθνείς εταίρους, το τμήμα αναπτύσσει και εφαρμόζει στρατηγικές απέλασης για πολίτες εκτός ΗΠΑ που αναμένουν απέλαση.	Capacity and Resources	el	2.0
Υποστηρίζουμε τις καθολικές πολιτικές για τα ανθρώπινα δικαιώματα και την προστασία των μεταναστών και των προσφύγων και ζητάμε πολυμερή δράση για την αντιμετώπιση των βαθύτερων αιτιών της μετανάστευσης, συμπεριλαμβανομένης της κλιματικής αλλαγής.	Capacity and Resources	el	2.0
Ένας μη κερδοσκοπικός οργανισμός που πληροί τα πρότυπα καταλληλότητας PA, πολιτειών και προγραμμάτων και έχει διοικητική ικανότητα να διαχειρίζεται καθορισμένα προγράμματα και κεφάλαια προγραμμάτων για λογαριασμό του CDSS.	Capacity and Resources	el	2.0
Εάν βρίσκεστε στις Ηνωμένες Πολιτείες χωρίς την εξουσιοδότηση ή την αποφυλάκιση ενός υπαλλήλου μετανάστευσης, η παράνομη ύπαρξή σας ξεκινά την ημερομηνία που εισήλθατε στη χώρα χωρίς άδεια ή υπό όρους.	Crime and Punishment	el	7.0
Γενικά, εάν έχετε γίνει δεκτός στις Ηνωμένες Πολιτείες ή έχετε αποφυλαχθεί από έναν υπάλληλο μετανάστευσης, θα λάβετε ένα Έντυπο Iâ94, Αρχείο Άφιξης/Προσπάθειας, με την ακριβή ημερομηνία που σκοπεύετε να φύγετε.	Crime and Punishment	el	7.0
Εάν εγκαταλείψετε τις Ηνωμένες Πολιτείες μετά την έναρξη των διαδικασιών απέλασης, συμπεριλαμβανομένης της οικειοθελούς απέλασης, είναι δική σας ευθύνη να ενημερώσετε το Διοικητικό Γραφείο Αναθεώρησης Μετανάστευσης.	Crime and Punishment	el	7.0
Η γραμμή 10 ετών ισχύει είτε φύγετε πριν, κατά τη διάρκεια ή αφού ξεκινήσετε την αφαίρεση του DHS.	Crime and Punishment	el	7.0
Ως εκ τούτου, μπορείτε να υποβάλετε εκ νέου αίτηση για άδεια εισόδου στις Ηνωμένες Πολιτείες, ακόμη και αν δεν έχετε γίνει μόνιμα δεκτοί, αλλά μόνο εάν δεν είστε φυσικά παρόντες στις Ηνωμένες Πολιτείες για τουλάχιστον 10 χρόνια μετά την τελευταία αναχώρησή σας.	Crime and Punishment	el	7.0
Ανάλογα με τα επιδόματα μετανάστευσης για τα οποία ζητάτε, ο νόμος μπορεί να σας αποκλείσει ως απαράδεκτους.	Crime and Punishment	el	7.0
"Πρέπει να γράψετε ""επιστροφή στις Ηνωμένες Πολιτείες εντός της νομικής περιόδου των τριών ή δέκα ετών"" για να διευκολύνετε την ταυτοποίηση και να αποφύγετε καθυστερήσεις στην απόρριψη του αρχείου."	Crime and Punishment	el	7.0
Ο νόμος περί μετανάστευσης και εθνικότητας (INA) περιγράφει τους λόγους για το απαράδεκτο ενός ατόμου.	Crime and Punishment	el	7.0
Ο αριθμός των παράνομων μεταναστών εγκληματιών στο Τέξας παραμένει χαμηλός επειδή οι παράνομοι μετανάστες παραμένουν απαρατήρητοι για χρόνια.	Crime and Punishment	el	7.0
Οι μετανάστες, συμπεριλαμβανομένων των Ισπανόφωνων μη υπηκόων, είναι ελαφρώς πιο πιθανό από τους ιθαγενείς να αναφέρουν έγκλημα, σύμφωνα με την Εθνική Έρευνα Αναφοράς Εγκλήματος, που έχει σχεδιαστεί για να μετρήσει την προθυμία των ανθρώπων να αναφέρουν το έγκλημα.	Crime and Punishment	el	7.0
Η αφομοίωση είναι η διαδικασία με την οποία μια μειονοτική ομάδα ή πολιτισμός υιοθετεί τη συμπεριφορά, τις αξίες, τα έθιμα και τις πεποιθήσεις της πλειοψηφικής ομάδας στη χώρα υποδοχής.	Cultural Identity	el	11.0
Ο όρος αφομοίωση χρησιμοποιείται συχνά για να περιγράψει τους μετανάστες που μετακινούνται σε ένα νέο μέρος. Ωστόσο, χρησιμοποιείται επίσης για τη συζήτηση φυλετικών ομάδων.	Cultural Identity	el	11.0
Οι Αβορίγινες, οι μετανάστες και οι εθνοτικές μειονότητες συχνά αλλάζουν ή κρύβουν πτυχές του πολιτισμού τους, συμπεριλαμβανομένης της γλώσσας, της διατροφής, του ντυσίματος και των πνευματικών πρακτικών τους, προκειμένου να υιοθετήσουν τις αξίες και τις κοινωνικές συμπεριφορές της κυρίαρχης κουλτούρας.	Cultural Identity	el	11.0
Είναι σημαντικό να θυμόμαστε ότι η εθελοντική κινητοποίηση είναι συχνά μια απάντηση στην πίεση από μια πιο κυρίαρχη κουλτούρα και ότι η προσαρμογή είναι η λύση για να διατηρηθούν οι άνθρωποι ασφαλείς και να επιβιώσουν. Αναγκαστική αφομοίωση: Πρόκειται για μια κατάσταση στην οποία μια μειονότητα ή μια φυλετική ομάδα αναγκάζεται να παραδοθεί. Οι πολιτιστικές τους ταυτότητες, οι γλώσσες, οι νόρμες και τα έθιμά τους αντιστοιχούν σε εκείνα της κυρίαρχης ομάδας.	Cultural Identity	el	11.0
Αν και αυτή ήταν μια κοινή διαδικασία μεταξύ των κρατών, έχει γίνει ένα διχαστικό πολιτικό ζήτημα – ορισμένοι πολιτικοί και το κοινό έχουν υποστηρίξει στο παρελθόν ότι οι Ευρωπαίοι μετανάστες αφομοιώθηκαν πιο γρήγορα από τις μειονότητες.	Cultural Identity	el	11.0
Σήμερα και στο παρελθόν, πολλοί λευκοί σε αυτήν τη χώρα θεωρούν τους μετανάστες και τις μειονότητες ως απειλή για την εθνική κουλτούρα, φοβούνται τις διαφορές μας και ασκούν άμεση και έμμεση πίεση, συμπεριλαμβανομένων απειλών, σε όσους διαφωνούν. και τη βία.	Cultural Identity	el	11.0
Η πολιτιστική αφομοίωση είχε σκοπό να περιορίσει τον αυτο-διαχωρισμό, αλλά κατά τη διάρκεια αυτής της περιόδου οι μετανάστες ενθαρρύνονταν να αφομοιωθούν για κοινωνική σταθερότητα και οικονομική ευημερία.	Cultural Identity	el	11.0
Μια άλλη μελέτη για οικογένειες μεταναστών διαπίστωσε ότι περισσότερα αδέρφια που γεννήθηκαν στο εξωτερικό ήταν πιο πιθανό να είναι άνεργα, να τελειώσουν το σχολείο σε λιγότερα χρόνια, να κερδίζουν λιγότερα και να παντρευτούν συζύγους που γεννήθηκαν στο εξωτερικό.	Cultural Identity	el	11.0
Ενώ η αναγκαστική αφομοίωση είναι μια μορφή βίας, το να αναγκάζονται οι μειονότητες να υιοθετούν πολιτιστικές πρακτικές που δεν τους ανήκουν είναι βία στην καλύτερη και στη χειρότερη.	Cultural Identity	el	11.0
Οι αυτόχθονες πληθυσμοί, οι εθνικές μειονότητες και οι μετανάστες βιώνουν συχνά την αφομοίωση με διαφορετικούς τρόπους, επομένως είναι σημαντικό να συζητήσουμε και να εξετάσουμε προσεκτικά πώς έγινε αυτή η αφομοίωση και οι επιπτώσεις της.	Cultural Identity	el	11.0
Στον κλάδο της φιλοξενίας, το 38 τοις εκατό των ιδιοκτητών επιχειρήσεων γεννήθηκαν εκτός των Ηνωμένων Πολιτειών, σε σύγκριση με το 24 τοις εκατό των ιδιοκτητών λιανικής.	Economic	el	1.0
Με 85 εκατομμύρια Αμερικανούς να ζουν σε κομητείες που έχασαν την αρχική τους ηλικία εργασίας μεταξύ 2011 και 2021 και 160 εκατομμύρια να ζουν σε κομητείες με μειωμένο ή σταθερό πληθυσμό, ήρθε η ώρα να αρχίσουμε να συζητάμε πώς η μετανάστευση σε επανασχεδιασμό σχετίζεται με την τοπική και περιφερειακή οικονομική ανάπτυξη. .	Economic	el	1.0
Οι 20 πολυπληθέστερες κομητείες των ΗΠΑ αντιπροσωπεύουν το 36 τοις εκατό των μεταναστών με τουλάχιστον πτυχίο, σε σύγκριση με το 19 τοις εκατό του συνολικού πληθυσμού της χώρας.	Economic	el	1.0
Ιδιαίτερα οι πολιτικοί του κράτους και της περιοχής πρέπει να δημιουργήσουν ένα πλαίσιο βάσης για να κατανοήσουν καλύτερα γιατί οι μετανάστες είναι σημαντικοί για την Αμερική και την αξία που προσφέρουν οι μετανάστες στις κοινότητές τους.	Economic	el	1.0
Η ελάχιστη επένδυση TEA αυξήθηκε σε 900.000 $ (από 500.000 $) για να ληφθεί υπόψη ο πληθωρισμός.	Economic	el	1.0
Το DHS ακολουθεί το παράρτημα [DHS/USCIS/ICE/CBP-001 Alien Document and National Document Tracking System, DHS/USCIS-007 Benefits Information System and DHS/USCIS-018 Immigration Biometrics and Background] και παρέχει μια εκτίμηση επιπτώσεων απορρήτου [DHS Assessment ]. ] εκδόσεις. /USCIS/PIA-016(a) Εφαρμοσμένο Σύστημα Πληροφοριών και Συνδεδεμένα με Υπολογιστή], διαθέσιμο στη διεύθυνση www.dhs.gov/privacy.	Economic	el	1.0
Ακόμη και μια διαφορά 10% στους μισθούς σε ένα ταξίδι μετ' επιστροφής ενός έτους θα επέτρεπε σε αυτούς τους εργαζομένους με χαμηλή ειδίκευση να βρουν δουλειά στις ΗΠΑ αντί να τους στείλουν σπίτι. Ένα αποτελεσματικό, καλά σχεδιασμένο και καλά εφαρμοσμένο πρόγραμμα κατά της φτώχειας μπορεί να αυξήσει το εισόδημα έως και 35 φορές από αυτό που ξεκίνησε.	Economic	el	1.0
Αλλά η τρέχουσα μισθολογική διαφορά και η αδιαμφισβήτητη ζήτηση εργασίας μεταξύ πλούσιων και φτωχών χωρών σημαίνει ότι κάθε ανθρώπινη μετακίνηση πραγματοποιείται χωρίς νόμιμα δικαιώματα και χωρίς την υποστήριξη των εργοδοτών.	Economic	el	1.0
Ο αντίκτυπος της μετανάστευσης στους μισθούς είναι αρνητικός για τους λιγότερο μορφωμένους οικιακούς εργαζόμενους και τα επαγγέλματα με υψηλότερα ποσοστά μεταναστών. 4 Η μετανάστευση επηρεάζει την απασχόληση καθώς και τον αντίκτυπό της στους μισθούς. Ευκαιρίες για ντόπιους εργαζόμενους.	Economic	el	1.0
Η εισροή μεταναστών έχει αυξήσει τον ανταγωνισμό για θέσεις εργασίας με αποτέλεσμα λιγότερες ευκαιρίες απασχόλησης για οικιακούς εργαζόμενους. Ωστόσο, η μετανάστευση είχε μικρό αντίκτυπο στις ευκαιρίες απασχόλησης. 6 Η καθαρή επίδραση της μετανάστευσης στην οικονομία των ΗΠΑ είναι θετική. 7 Οι μετανάστες αυξάνουν τον αριθμό των εργαζομένων στην οικονομία, οδηγώντας σε υψηλότερη οικονομική ανάπτυξη και υψηλότερους μισθούς για τους οικιακούς εργαζόμενους.	Economic	el	1.0
Οι νέοι κανόνες δίνουν στους αιτούντες άσυλο περισσότερη εξουσία να ακούν και να αποφασίζουν σχετικά με αιτήματα ασύλου (υποθέσεις που συνήθως δίνονται σε δικαστές μετανάστευσης) όταν εμφανίζονται στα νότια σύνορα των ΗΠΑ.	External Regulation and Reputation	el	14.0
Οι δείκτες διαχείρισης της μετανάστευσης (MGI) παρέχουν ένα πλαίσιο που βοηθά στην αξιολόγηση της ακεραιότητας των εθνικών πολιτικών μετανάστευσης και στον εντοπισμό κενών και προτεραιοτήτων για τη δημιουργία θεσμικών ικανοτήτων και τα προγράμματα μετανάστευσης.	External Regulation and Reputation	el	14.0
Λαμβάνονται υπόψη διάφορες υποδιαστάσεις κάθε κατηγορίας πολιτικής, συμπεριλαμβανομένων της επιλεξιμότητας, των προϋποθέσεων, των εγγυήσεων του καθεστώτος και των συναφών δικαιωμάτων.	External Regulation and Reputation	el	14.0
Ο πίνακας ελέγχου οργανώνεται γύρω από πέντε διαστάσεις πολιτικής: θεσμική συνοχή, μείωση του κόστους μετανάστευσης, προστασία των δικαιωμάτων των μεταναστών και των οικογενειών, προώθηση της ένταξης και επανένταξης και αύξηση του αντίκτυπου της μετανάστευσης στην ανάπτυξη.	External Regulation and Reputation	el	14.0
Οι κανονισμοί μετανάστευσης περιέχονται στον Τίτλο 8 του Κώδικα Ομοσπονδιακών Κανονισμών (Ξένοι και Πολίτες), ο οποίος είναι ισοδύναμος με τον Τίτλο 8 του Κώδικα των Ηνωμένων Πολιτειών (Αλλοδαποί και εθνικότητες).	External Regulation and Reputation	el	14.0
Οι ανάγκες και οι προκλήσεις για την προώθηση της ισότητας των φύλων και της δικαιοσύνης είναι εμφανείς σε όλο τον κόσμο.	Fairness and Equality	el	4.0
Έχει δημιουργήσει εξαιρετική ηγεσία και ικανότητα στα υψηλότερα πολιτικά επίπεδα, συμπεριλαμβανομένης της κυβέρνησης των Ηνωμένων Πολιτειών, του Λευκού Οίκου, του Στέιτ Ντιπάρτμεντ και της αποστολής των Ηνωμένων Πολιτειών στα Ηνωμένα Έθνη, του Οργανισμού Διεθνούς Ανάπτυξης (USAID) και του Υπουργείου Υγεία. Ανθρώπινο δυναμικό. και Ανθρωπίνων Υπηρεσιών (HHS).	Fairness and Equality	el	4.0
Καθώς η κυβέρνηση Τραμπ συνεχίζει να επιτίθεται σε ζητήματα φύλου, ιδιαίτερα σεξουαλικής και αναπαραγωγικής υγείας και δικαιωμάτων LGBTQI+, η κυβέρνηση Μπάιντεν αντιμετωπίζει μια στρατηγική επιταγή να προωθήσει την ισότητα και την ισότητα των φύλων που απαιτούνται για την επίτευξη των στόχων παγκόσμιας υγείας και ανάπτυξης των ΗΠΑ. δείχνει ότι μπορεί να επιτευχθεί οικονομική ευημερία και εθνική ασφάλεια.	Fairness and Equality	el	4.0
Ενώ άλλες διοικήσεις έχουν γραφεία αφιερωμένα σε γυναίκες και κορίτσια, το τρέχον Συμβούλιο Πολιτικής Φύλου του Λευκού Οίκου είναι το πρώτο συμβούλιο πολιτικής στην Προεδρία που επικεντρώνεται στην ισότητα των φύλων και την ισότητα των φύλων, συμπεριλαμβανομένων των γυναικών και των κοριτσιών, αλλά είναι πιο περιεκτικό και ευρύ. . Ατζέντα για το φύλο, συμπεριλαμβανομένων ζητημάτων LGBTQI+.	Fairness and Equality	el	4.0
Ο Λευκός Οίκος πιθανότατα θα έχει την ευθύνη της οργάνωσης και του συντονισμού διυπηρεσιακών διαδικασιών που πρέπει να διαχειριστούν τις εντάσεις και τον ανταγωνισμό μεταξύ υπηρεσιών και ιδρυμάτων και απαιτούν συνεχή υποστήριξη υψηλού επιπέδου και προσωπικό από τη διοίκηση.	Fairness and Equality	el	4.0
Σύμφωνα με το Εμπορικό Επιμελητήριο των ΗΠΑ, η Διαφορετικότητα, η Ισότητα και η Ένταξη (που συχνά αποκαλείται DEI) είναι ένα πλαίσιο κοινωνικής ανάπτυξης που μπορεί να εφαρμοστεί σε επιχειρηματικά περιβάλλοντα.	Fairness and Equality	el	4.0
Η πανδημία έχει επιδεινώσει τις υγειονομικές και οικονομικές προκλήσεις που αντιμετωπίζουν οι μετανάστες και έχει γίνει όλο και πιο σημαντικό να αντιμετωπιστούν οι ανάγκες των μεταναστών καθώς η δραστηριότητα των μεταναστών αυξάνεται κατά μήκος των συνόρων ΗΠΑ-Μεξικού.	Health and Safety	el	9.0
Αν και πολλοί μη ηλικιωμένοι πολίτες ζουν σε νοικοκυριά με εργαζομένους πλήρους απασχόλησης, αντιμετωπίζουν λιγότερη πρόσβαση σε ιδιωτική ασφάλιση, καθώς είναι πιο πιθανό να εργαστούν σε χαμηλούς και χαμηλούς μισθούς και σε κλάδους όπου οι εργοδότες είναι λιγότερο πιθανό να παρέχουν συντάξεις. - Αναφορές χορηγίας.	Health and Safety	el	9.0
Β. Ορισμένοι μετανάστες, όπως οι κάτοχοι καθεστώτος προσωρινής προστασίας, είναι νόμιμοι αλλά δεν πληρούν τις προϋποθέσεις και δεν πληρούν τις προϋποθέσεις για Medicaid ή CHIP, ανάλογα με τη διάρκεια παραμονής τους στη χώρα.	Health and Safety	el	9.0
Τα άτομα με καθεστώς DACA δεν θεωρούνται νομίμως διαθέσιμα για καταλληλότητα ασφάλισης υγείας και δεν πληρούν τις προϋποθέσεις για επιλογές κάλυψης σύμφωνα με κανονισμούς που εκδίδονται από τα Κέντρα Υπηρεσιών Medicare και Medicaid (CMS).	Health and Safety	el	9.0
Παρόλο που πληρούν τις προϋποθέσεις για κάλυψη, πολλές οικογένειες μεταναστών παραμένουν ανασφάλιστες λόγω των πολλών εμποδίων που αντιμετωπίζουν κατά την εγγραφή, όπως φόβος, σύγχυση σχετικά με τη διαδικασία επιλεξιμότητας, δυσκολίες με τη διαδικασία εγγραφής και ζητήματα γλώσσας και γραμματισμού.	Health and Safety	el	9.0
Η έρευνα δείχνει ότι οι αλλαγές της κυβέρνησης Τραμπ στη μεταναστευτική πολιτική αναγκάζουν τις οικογένειες μεταναστών να ανησυχούν όλο και περισσότερο για την εγγραφή τους ή/και των παιδιών τους στο Medicaid και στο CHIP, παρά το γεγονός ότι είναι επιλέξιμες.	Health and Safety	el	9.0
"Jennifer Chacon, ""Οι πολιτείες έχουν περάσει νόμους που έχουν σχεδιαστεί για να απαγορεύουν σε όλες τις ομάδες ανθρώπων να εισέρχονται σε κρατικές γραμμές, συμπεριλαμβανομένων εκείνων με ποινικό μητρώο, δικαιούχων δημόσιας επιχορήγησης, σκλάβων και ελεύθερων μαύρων."""	Legality, Constitutionality, Jurisdiction	el	5.0
"""Η Amanda Frost είναι μια συναρπαστική προσθήκη στη σχολή μας με την τεχνογνωσία και την εμπειρία της στο μεταναστευτικό και το συνταγματικό δίκαιο"", δήλωσε η Dean Risa Goluboff."	Legality, Constitutionality, Jurisdiction	el	5.0
«Η ιδέα για αυτό το βιβλίο ήρθε στο μυαλό μου όταν είδα ιστορίες ανθρώπων που έχασαν την υπηκοότητά τους σε όλη την αμερικανική ιστορία και συνειδητοποίησα ότι αυτό είναι ένα πολύ ευρύτερο φαινόμενο από ό,τι πίστευα προηγουμένως», είπε ο Φροστ.	Legality, Constitutionality, Jurisdiction	el	5.0
Βλέποντας το σύστημα ποινικής δικαιοσύνης σε δράση, «ήθελε να είναι μέρος του και να εκπροσωπεί ανθρώπους που δεν ήθελαν να ακουστεί η φωνή τους». Μετά το κολέγιο, εργάστηκε ως βοηθός δικηγόρου στο δίκαιο των πολιτικών δικαιωμάτων για ένα χρόνο. Έκανε αίτηση για να σπουδάσει νομικά στο ινστιτούτο και στη σχολή που αποφοίτησε.	Legality, Constitutionality, Jurisdiction	el	5.0
«Βρίσκω ενδιαφέροντα θέματα [μεταναστευτικής] σε όλα τα μέτωπα, από πολιτικά ζητήματα μέχρι νομικές ερμηνείες και σύνθετα συνταγματικά ζητήματα σχετικά με τις σχέσεις μεταξύ των τριών κλάδων της κυβέρνησης», είπε.	Legality, Constitutionality, Jurisdiction	el	5.0
Οι κρατικές αρχές επιτρέπεται επίσης να επιβάλλουν τους ομοσπονδιακούς νόμους περί μετανάστευσης συλλαμβάνοντας μετανάστες που είχαν προηγουμένως καταδικαστεί για εγκλήματα.	Legality, Constitutionality, Jurisdiction	el	5.0
"Κοιτάς αυτόν τον αξιωματικό και λες, ""Δεν μπορείς να με κοιτάς και να πεις ότι είμαι καλός;"" Μπορεί να σκέφτεστε. Δυστυχώς αυτό δεν είναι αλήθεια. επαρκής"	Morality	el	3.0
Επομένως, εάν καπνίζετε μαριχουάνα για ιατρική χρήση ή μαριχουάνα για ψυχαγωγία, μπορεί να θεωρηθείτε ηθικά κατώτερο άτομο, ακόμα κι αν είναι νόμιμο στην πολιτεία σας και δεν έχετε συλληφθεί ή καταδικαστεί ποτέ για ελεγχόμενη ουσία.	Morality	el	3.0
Ηθικός χαρακτήρας και Νόμιμος Μόνιμος Κάτοικος (LPR). Εάν είστε νόμιμος μόνιμος κάτοικος (LPR) και επιθυμείτε να υποβάλετε αίτηση για υπηκοότητα/ιθαγένεια ΗΠΑ, πρέπει να επιδείξετε αποδεκτό ηθικό χαρακτήρα στους υπαλλήλους της USCIS κατά τη διάρκεια της νόμιμης μόνιμης διαμονής σας.	Morality	el	3.0
Ηθικός Χαρακτήρας και Διαδικασία στα Δικαστήρια Μετανάστευσης. Όταν ένα άτομο υπόκειται σε απέλαση ή απομάκρυνση από το USCIS, πρέπει να αποδεικνύεται καλός ηθικός χαρακτήρας.	Morality	el	3.0
Σε ένα τυπικό παράδειγμα, όταν κάποιος υποβάλλει αίτηση για υπηκοότητα ΗΠΑ λόγω σοβαρού τραύματος ή συναισθηματικής κακοποίησης, τα στοιχεία σημαντικών επιτευγμάτων κατά τη διάρκεια του χρόνου τους στις ΗΠΑ θα μπορούσαν να υπονομεύσουν ολόκληρη την υπόθεση αυτού του ατόμου.	Morality	el	3.0
Εάν δεν υποβάλουν αίτηση στο πρώτο έτος, χάνουν την ευκαιρία να λάβουν άσυλο.	Other	el	15.0
Περισσότεροι από 200.000 Αφγανοί, Ουκρανοί, Βενεζουελάνοι, Νικαράγουαν, Κουβανοί και Αϊτινοί έχουν περάσει από την πιο επίσημη ανθρωπιστική διαδικασία αποφυλάκισης υπό όρους.	Other	el	15.0
Αξιωματούχοι του Λευκού Οίκου και της Εσωτερικής Ασφάλειας άρχισαν να συζητούν πρόσθετους περιορισμούς για τον περιορισμό της εισόδου των μεταναστών στις Ηνωμένες Πολιτείες εν μέσω της μεταναστευτικής κρίσης και των συνόρων ΗΠΑ-Μεξικού.	Other	el	15.0
«Λόγω διαχείρισης, λαμβάνουμε υπόψη όλα τα νομικά ζητήματα πριν προχωρήσουμε σε οποιαδήποτε πολιτική και οι πρόσφατα προτεινόμενοι κανονισμοί αντικατοπτρίζουν αυτές τις σκέψεις», δήλωσε κυβερνητικός αξιωματούχος σε δήλωση.	Other	el	15.0
Οι προτάσεις για τη μεταρρύθμιση του μεταναστευτικού συστήματος έχουν σταματήσει καθώς οι αρχές συλλαμβάνουν αριθμούς ρεκόρ μεταναστών που φτάνουν στα νότια σύνορα των ΗΠΑ, ανέφεραν πηγές στο CNN.	Other	el	15.0
«Αυτή δεν είναι η κορυφαία προτεραιότητά μας, δεν είναι η δεύτερη προτεραιότητά μας», είπε νωρίτερα ένας αξιωματούχος της κυβέρνησης στους δημοσιογράφους, τονίζοντας τις προσπάθειες να ανοίξει η νόμιμη πρόσβαση, συμπεριλαμβανομένης της χρήσης εφαρμογών, στις ΗΠΑ και τόνισε ότι η ευθύνη για την ψήφιση των μεταρρυθμίσεων ανήκει στο Κογκρέσο. .	Other	el	15.0
Ως μέρος της ιατρικής εξέτασης μετανάστευσης, ο αιτών, ο πολιτικός χειρουργός και όλοι οι άλλοι πάροχοι υγειονομικής περίθαλψης που αξιολογούν τον αιτούντα πρέπει να υπογράψουν το έντυπο και να πιστοποιήσουν ότι αυτά που είπαν είναι αληθή.	Policy Prescription and Evaluation	el	6.0
Εάν ο πρόσφυγας χρειάζεται μόνο το τεστ εμβολιασμού, τα μέρη του εντύπου που πρέπει να συμπληρωθούν είναι Πληροφορίες Αίτησης, Δοκιμή Εμβολίου και Πιστοποιητικό.	Policy Prescription and Evaluation	el	6.0
Το USCIS δέχεται έναν αιτούντα που επηρεάζεται από μια συγκεκριμένη σωματική ή αναπτυξιακή αναπηρία ή διανοητική αναπηρία, ενώ ένας άλλος αιτών που επηρεάζεται από την ίδια αναπηρία ή διαταραχή είναι επιλέξιμος για παραίτηση από αναπηρία.	Policy Prescription and Evaluation	el	6.0
Εξαίρεση αναπηρίας μπορεί να ληφθεί μόνο με τη συμπλήρωση του Έντυπου N-648, το οποίο απαιτεί απόδειξη ότι η σωματική ή διανοητική αναπηρία ή διανοητική αναπηρία του αιτούντος εμποδίζει τον αιτούντα να πληροί τις απαιτήσεις αγγλικής γλώσσας ή υπηκοότητας ή και τα δύο. λογική διαμονή.	Policy Prescription and Evaluation	el	6.0
Οι μεταφραστές που παρέχουν υπηρεσίες μετάφρασης για ιατρικές εξετάσεις τηλευγείας δεν απαιτείται να συμπληρώσουν το Έντυπο N-648, Πιστοποίηση διερμηνέα.	Policy Prescription and Evaluation	el	6.0
Για χρόνια, το Κογκρέσο απέτυχε να συμφωνήσει για συνολική μεταρρύθμιση της μετανάστευσης, μετατοπίζοντας ουσιαστικά ορισμένες βασικές αποφάσεις πολιτικής στην εκτελεστική και δικαστική εξουσία και πυροδοτώντας συζητήσεις στις αίθουσες της πολιτείας και της τοπικής αυτοδιοίκησης.	Political	el	13.0
Οι κινήσεις του Μπάιντεν για την αντιστροφή των πολιτικών της εποχής Τραμπ περιλαμβάνουν τη μείωση των αμερικανικών κυρώσεων για τη μετανάστευση, τον τερματισμό της ταξιδιωτικής απαγόρευσης, την άρση του μορατόριουμ στην επεξεργασία της πράσινης κάρτας και την παύση της κατασκευής ενός τείχους κατά μήκος των συνόρων ΗΠΑ-Μεξικού.	Political	el	13.0
Εν τω μεταξύ, μια ιστορική εισροή μεταναστών στα νότια σύνορα απειλεί να υπονομεύσει περαιτέρω τις προσπάθειες του Μπάιντεν: Τον Μάιο του 2022, οι συλλήψεις στα σύνορα έφτασαν σχεδόν τις 240.000, ένα υψηλό 20 ετών μετά από μια μείωση που σχετίζεται με την επιδημία.	Political	el	13.0
Στη Σύνοδο Κορυφής της Αμερικής το 2022, 23 ηγέτες του δυτικού ημισφαιρίου συμφώνησαν σε μια συμφωνία μετανάστευσης με στόχο την αύξηση της βοήθειας προς τον πληθυσμό των προσφύγων, τη βελτίωση της διαχείρισης των συνόρων και τον καλύτερο συντονισμό απόκρισης έκτακτης ανάγκης.	Political	el	13.0
Ο Μπάιντεν και ο Μεξικανός πρόεδρος Αντρές Μανουέλ Λόπες Ομπραδόρ επισκέφτηκαν επίσης τις νότιες Ηνωμένες Πολιτείες. Έχει προταθεί ένα κοινό σχέδιο υποδομής για την ασφάλεια των συνόρων για την παράταση των προσωρινών θεωρήσεων εργασίας και την αύξηση των επενδύσεων στην επιτήρηση των συνόρων.	Political	el	13.0
«Πριν από τη δεκαετία του '20, η γενική τάση της συζήτησης για τη μετανάστευση ήταν αρνητική, αλλά μέσα σε μια γενιά - από το 1945 έως το 1965 - έγινε πολύ θετική», δήλωσε ο Ρον Αμπράμιτζκι, καθηγητής οικονομικών και οικονομικός ιστορικός. Το Πανεπιστήμιο του Στάνφορντ συνεργάστηκε με ερευνητές τεχνητής νοημοσύνης για να δημοσιεύσει τη νέα εργασία.	Public Sentiment	el	12.0
Εκτός από την Card και τον Abramitzky, η ομάδα περιλαμβάνει τη Serena Chang, επιστήμονα υπολογιστών στο Stanford. Chris Baker, οικονομολόγος στο Stanford. Julia Mendelsohn, επιστήμονας πληροφοριών στο Πανεπιστήμιο του Μίσιγκαν. Ο Dan Jurafsky είναι καθηγητής γλωσσολογίας και πληροφορικής στο Stanford. ; καθηγητής; Rob Voigt, Επίκουρος Καθηγητής Γλωσσολογίας, Πανεπιστήμιο Northwestern.	Public Sentiment	el	12.0
Για να αναπτύξει ένα μοντέλο μηχανικής μάθησης που θα μπορούσε να αναγνωρίσει με ακρίβεια τις φωνές των μεταναστών, η ομάδα σημείωσε με μη αυτόματο τρόπο δείγματα ομιλίας ανθρώπων ερευνητών για να καθορίσει εάν ήταν θετικοί, αρνητικοί ή ουδέτεροι και πώς απεικόνιζαν τους μετανάστες.	Public Sentiment	el	12.0
Ο τόνος υπέρ των μεταναστών στις πρόσφατες πολιτικές ομιλίες αντανακλά το αυξανόμενο θετικό κλίμα σε ολόκληρη τη χώρα.	Public Sentiment	el	12.0
Όπως αναφέρθηκε τον περασμένο μήνα, η παράνομη μετανάστευση είναι το δεύτερο υψηλότερο δημόσιο ζήτημα όσον αφορά τη φυλετική ένταξη μεταξύ των 14 ζητημάτων που αξιολογήθηκαν φέτος.	Public Sentiment	el	12.0
«Δεν χρειάζεται να πιέσουμε τον Πρόεδρο Μπάιντεν για την απαγόρευση του ασύλου, κινητοποιούμε τους ανθρώπους να υψώσουν τη φωνή τους ενάντια σε αυτό το τρομερό λάθος», δήλωσε ο Μπιλάλ Ασιάρ, προσωρινός διευθυντής της εκστρατείας του Συνασπισμού #WelcomeWithDignity. Μεταναστευτικό Δίκαιο και Νομικοί θεσμοί.	Public Sentiment	el	12.0
Ο Παγκόσμιος Οργανισμός Υγείας ορίζει την ποιότητα ζωής ως μια υποκειμενική αξιολόγηση της αντίληψης κάποιου για την πραγματικότητα σχετικά με τους στόχους του, ιδωμένη μέσα από το πρίσμα της κουλτούρας και του συστήματος αξιών του.	Quality of Life	el	10.0
Θα κοστίσει στο σύστημα ασύλου μας εκατομμύρια δολάρια σε διοικητικά έξοδα και νομική βοήθεια για όσους κάνουν κατάχρηση του συστήματος με αβάσιμους, ψευδείς ή κακόβουλους ισχυρισμούς - βλ. Η ενημέρωσή μας για την επιβάρυνση και το αυξανόμενο κόστος της κατάχρησης του συστήματος ασύλου.	Quality of Life	el	10.0
Η κυκλοφοριακή συμφόρηση επιδεινώνεται – το Λονδίνο είναι πλέον η πιο συμφορημένη πόλη στον κόσμο, με την αυξανόμενη κυκλοφοριακή συμφόρηση να οδηγεί στην φρενήρη απόφαση της κυβέρνησης να στραφεί σε «έξυπνους αυτοκινητόδρομους», διαπίστωσε η εταιρεία δεδομένων κυκλοφορίας Enrix. Μειώστε την ασφάλεια οδήγησης και θέστε τις οικογένειες σε κίνδυνο, απαλλαγείτε από τους σκληρούς ώμους.	Quality of Life	el	10.0
Και όλα αυτά χωρίς να αναφέρουμε τον εφιάλτη δημόσιας ασφάλειας που δημιουργεί η αδυναμία εντοπισμού των χιλιάδων λαθρομεταναστών που εισήλθαν στη χώρα με βάρκα, αεροπλάνα και φορτηγά, καθώς και η τάση να καταστρέφονται σκόπιμα τα έγγραφα ταυτότητας όσων εισέρχονται στη χώρα. .	Quality of Life	el	10.0
Οι νόμοι που εισάγουν διακρίσεις σε βάρος των μη πολιτών και τα προγράμματα και οι πολιτικές που αποτυγχάνουν να αντιμετωπίσουν τις ειδικές ανάγκες και τις ευπάθειές τους συχνά εμποδίζουν τις οικογένειες και τις οικογένειές τους να έχουν πρόσβαση σε βασικές υπηρεσίες.	Quality of Life	el	10.0
Η ικανότητα μιας γυναίκας να μετεγκατασταθεί μπορεί να περιορίζεται από προσωπικούς και οικογενειακούς παράγοντες όπως η ηλικία, η αρχαιότητα της οικογένειας, η φυλή/εθνικότητα, η οικογενειακή κατάσταση και η παρουσία ή η απουσία παιδιών.	Quality of Life	el	10.0
Οι μετανάστες απανθρωποποιούνται, κατηγορούνται, κρατούνται αυθαίρετα και μερικές φορές χωρίζονται από τα παιδιά τους λόγω των εθνοτικών τους πεποιθήσεων.	Quality of Life	el	10.0
Τα εμπόδια και τα τείχη πηγάζουν από την πεποίθηση ότι το κλείσιμο ασφαλών και τακτοποιημένων διαδρομών κίνησης και η σκόπιμη σκλήρυνση θα κάνει τους ανθρώπους λιγότερο πρόθυμους να εγκαταλείψουν τη γη τους.	Quality of Life	el	10.0
Οι μετανάστες πρέπει να δείξουν ότι φοβούνται τη δίωξη όταν επιστρέψουν στην πατρίδα τους.	Quality of Life	el	10.0
Αυτός ο αριθμός καθορίστηκε από έρευνες σε άτομα σε ολόκληρη τη χώρα για διάφορα θέματα, όπως η οικονομική προσιτότητα της στέγασης, το κόστος ζωής, ο χρόνος ταξιδιού, η ρύπανση, η εγκληματικότητα, η υγεία, η αγοραστική δύναμη, η ψυχαγωγία και η απασχόληση.	Quality of Life	el	10.0
Από την 11η Σεπτεμβρίου, το Υπουργείο Εσωτερικής Ασφάλειας (DHS) και η ομοσπονδιακή κυβέρνηση, μαζί με τους πολλούς εταίρους του στον δημόσιο και ιδιωτικό τομέα και σε κοινότητες σε εθνικό και παγκόσμιο επίπεδο, εργάστηκαν για να αποκαταστήσουν δραματικά και να βελτιώσουν ό,τι είναι νέο. πατρίδα. Ασφάλεια Φυσική ασφάλεια. Οι δυναμικές απειλές βελτιώνουν την ικανότητα μετριασμού, απόκρισης και ανάκαμψης από όλους τους τύπους επιθέσεων και καταστροφών.	Security and Defense	el	8.0
Οι Υπηρεσίες Ιθαγένειας και Μετανάστευσης (USCIS) ενημέρωσαν τις άδειες απασχόλησής τους για να συμπεριλάβουν ένα μηχανικά αναγνώσιμο πεδίο που επιτρέπει στους αξιωματικούς του συνοριακού ελέγχου να εντοπίζουν πιο αποτελεσματικά άτομα που έχουν λάβει έγκριση για μετανάστευση και έχουν προηγουμένως ελεγχθεί από αξιωματικούς της USCIS.	Security and Defense	el	8.0
Η ακτοφυλακή των ΗΠΑ ενισχύει την ικανότητα του Πολεμικού Ναυτικού να ανταποκρίνεται σε απειλές δημιουργώντας μια σημαντική αμερικανική δύναμη με παρουσία και ανάπτυξη ομάδων μάχης, αντιτρομοκρατίας και όπλα μαζικής καταστροφής. Δυνατότητα γρήγορης ανταπόκρισης σε ομάδες ασφάλειας θαλάσσης και λιμενικής ασφάλειας. Απειλές εσωτερικής περιήγησης και επακόλουθες απαντήσεις.	Security and Defense	el	8.0
Ανίχνευση ακτινοβολίας: Η CBP έχει αναπτύξει οθόνες πύλης ακτινοβολίας και άλλες τεχνολογίες ανίχνευσης ακτινοβολίας σε λιμάνια, χερσαία σύνορα και ταχυδρομικές εγκαταστάσεις σε όλο τον κόσμο.	Security and Defense	el	8.0
Από την 11η Σεπτεμβρίου, το Υπουργείο Εσωτερικής Ασφάλειας (DHS) και η ομοσπονδιακή κυβέρνηση, μαζί με τους πολλούς εταίρους του στον δημόσιο και ιδιωτικό τομέα και σε κοινότητες σε εθνικό και παγκόσμιο επίπεδο, εργάστηκαν για να αποκαταστήσουν δραματικά και να βελτιώσουν ό,τι είναι νέο. πατρίδα. Ασφάλεια Φυσική ασφάλεια. Οι δυναμικές απειλές βελτιώνουν την ικανότητα μετριασμού, απόκρισης και ανάκαμψης από όλους τους τύπους επιθέσεων και καταστροφών.	Security and Defense	el	8.0
Οι σύγχρονοι αναγνώστες μπορεί να θαυμάσουν τους «ανδρικούς και γυναικείους» γάμους που οργανώθηκαν από συλλόγους ανδρών και γυναικών στις αρχές του 20ου αιώνα για να συγκεντρώσουν χρήματα για τα Liberty Bonds.	Capacity and Resources	el	2.0
Εξέτασε τις πολιτιστικές πτυχές της ομοφυλοφιλίας όπως ο Ιησούς, ο πλασματικός γάμος του και η ιστορία του Μαρκ Τουέιν - πώς παντρεύτηκε την Κέιτ Γουίλσον, το έργο της οποίας η Νάνσυ Τζάκσον δεν είχε τολμήσει να δημοσιεύσει.	Capacity and Resources	el	2.0
Μετά από μια ιδιωτική ακρόαση: Σε μια υπόθεση δολοφονίας στο Σικάγο το 1923, ο δικαστής αποφάνθηκε ότι «το γεγονός ότι ο Thompson ήταν άνδρας δεν επηρέασε την ιδιότητά του ως συζύγου, κάτι που ήταν θέμα ερμηνείας του νόμου». Δεν επετράπη στον Thompson να καταθέσει. , γιατί τότε μια γυναίκα μπορούσε να καταθέσει για λογαριασμό του συζύγου της».	Capacity and Resources	el	2.0
Τα ζευγάρια του ίδιου φύλου —όπως τα δεμένα ζευγάρια, τα μικτά ζευγάρια, τα αυτοεξαρτώμενα ζευγάρια και η πολυγαμία— μπορεί να είναι ή να μην είναι νόμιμα στα μάτια του κράτους, αλλά υπάρχουν.	Capacity and Resources	el	2.0
Όπως ρωτά ο Cliffs, «Πρέπει να γίνουν κατανοητοί ως γκέι ή ακόμα να πλαισιώνονται σε μια τρανς ιστορία που ορίζεται από την ιστορία των γκέι και των λεσβιών;	Capacity and Resources	el	2.0
Τα άτομα LGBTQ+ που είναι ήδη παντρεμένα δηλώνουν ότι η απαγόρευση εξακολουθεί να τους επιτρέπει να παντρευτούν.	Crime and Punishment	el	7.0
Τα άτομα LGBTQ+ που θέλουν να παντρευτούν σε 32 πολιτείες που δεν έχουν ίσα δικαιώματα γάμου πρέπει να παντρευτούν πέρα ​​από τις πολιτειακές γραμμές και να αναγνωρίσουν το κράτος τους την ένωσή τους.	Crime and Punishment	el	7.0
Τι σημαίνει το νομοσχέδιο για τους παντρεμένους σε πολιτείες που απαγορεύουν τον γάμο LGBTQ+;	Crime and Punishment	el	7.0
Εάν το Ανώτατο Δικαστήριο ανατρέψει την ισότητα του γάμου, υπάρχει τρόπος να αποκατασταθεί η ισότητα του γάμου σε εθνικό επίπεδο;	Crime and Punishment	el	7.0
Ο Clarence Thomas, ένας από τους δικαστές της πλειοψηφίας που ανέτρεψε τον Roe, έγραψε μια κοινή γνώμη υποστηρίζοντας ότι το Δικαστήριο πρέπει να «επανεξετάσει» τον Obergefell, χαρακτηρίζοντάς το ως μία από τις λανθασμένες αποφάσεις του Δικαστηρίου. Ο Ρο μένει στη θέση του για πολύ λίγο πριν λιποθυμήσει.	Crime and Punishment	el	7.0
Τα ομόφυλα ζευγάρια έχουν κερδίσει τη μάχη για την ισότητα του γάμου και απολαμβάνουν πολλά, αν όχι όλα, από τα συζυγικά οφέλη που προβλέπονται από την ομοσπονδιακή και πολιτειακή νομοθεσία.	Economic	el	1.0
Σε ορισμένες πολιτείες και την Περιφέρεια της Κολούμπια, τα παντρεμένα ζευγάρια μπορούν να αποκτήσουν τίτλους περιουσιακών στοιχείων όπως τα σπίτια και οι τραπεζικοί τους λογαριασμοί, περιορίζοντας τον τρόπο με τον οποίο οι δανειστές μπορούν να προσαρτήσουν ορισμένα περιουσιακά στοιχεία με τίτλο.	Economic	el	1.0
Για άγαμους οικιακούς συντρόφους που λαμβάνουν τα ίδια επιδόματα εργαζομένων (εάν ο εργοδότης επωφελείται επίσης από τον οικιακό σύντροφο), η αξία των παροχών του οικιακού συντρόφου συνήθως ισούται με το φορολογητέο εισόδημα του εργαζομένου επί του ομοσπονδιακού φόρου εισοδήματος.	Economic	el	1.0
Τώρα που αναγνωρίζεται ο γάμος ομοφύλων, τα ζευγάρια του ίδιου φύλου μπορούν να απολαμβάνουν την άνεση να γνωρίζουν ότι είναι νόμιμα με τους συγγενείς τους όταν πρόκειται να αποφασίσουν για έναν άρρωστο σύζυγο και να ελέγξουν τα περιουσιακά στοιχεία του συζύγου τους. Θάνατος είναι η απουσία άλλων διευθετήσεων.	Economic	el	1.0
Ο οικονομικός αντίκτυπος του γάμου μεταξύ ατόμων του ιδίου φύλου είναι θετικός για την πολιτεία και τις τοπικές οικονομίες καθώς και για τη βιομηχανία των γάμων.	Economic	el	1.0
Διεθνείς οργανισμοί, συμπεριλαμβανομένων των Ηνωμένων Εθνών, έχουν εκδώσει ψηφίσματα που υποστηρίζουν τα δικαιώματα LGBTQ+, αλλά οι ομάδες ανθρωπίνων δικαιωμάτων λένε ότι έχουν περιορισμένες εξουσίες για την επιβολή τους.	External Regulation and Reputation	el	14.0
«Κανένας διπλωμάτης με τα καλά του μυαλά δεν θα το θεωρούσε καλή ιδέα να επισκεφτεί μια χώρα που δεν είναι έτοιμη για γάμο ομοφύλων», είπε ο Ντορφ.	External Regulation and Reputation	el	14.0
Ενώ η δημόσια υποστήριξη για τους γάμους ομοφύλων αυξάνεται, η συζήτηση μεταξύ ατόμων και οργανώσεων που υποστηρίζουν τη νομική ισότητα και εκείνων που αντιτίθενται στην ισότητα του γάμου με βάση τη θρησκεία συνεχίζεται.	External Regulation and Reputation	el	14.0
Στα τέλη του 20ου αιώνα, με την απελευθέρωση των στάσεων απέναντι στην ομοφυλοφιλία και τους νόμους που διέπουν την ομοφυλοφιλική συμπεριφορά, ειδικά στη Δυτική Ευρώπη και τις Ηνωμένες Πολιτείες, το ακαδημαϊκό και δημόσιο ενδιαφέρον για το θέμα αυξήθηκε.	Cultural Identity	el	11.0
Στις αρχές της δεκαετίας του 2000, πολλές χώρες και τοπικές δικαιοδοσίες νομιμοποίησαν τους γάμους ομοφύλων. Σε άλλες δικαιοδοσίες, έχουν ληφθεί συνταγματικά μέτρα για την αποτροπή της επιτρεπόμενης γάμου μεταξύ ατόμων του ίδιου φύλου ή έχουν ψηφιστεί νόμοι που αρνούνται την αναγνώριση τέτοιων γάμων που έγιναν αλλού.	Cultural Identity	el	11.0
Το γεγονός ότι διαφορετικές ομάδες αναλύουν την ίδια συμπεριφορά με πολύ διαφορετικούς τρόπους καταδεικνύει τη σημασία της ως κοινωνικό πρόβλημα στις αρχές του 21ου αιώνα. Δείχνει επίσης ότι υπάρχει πολιτισμική ποικιλομορφία εντός και μεταξύ των χωρών.	Cultural Identity	el	11.0
Οι πιο συνηθισμένες μορφές τεκμηρίωσης είναι οι γάμοι κοινού δικαίου. Γάμοι Morgan στους οποίους ο τίτλος και η περιουσία δεν περνούν σε παιδιά. γάμους ανταλλαγής, στους οποίους ένας αδελφός σε μια οικογένεια παντρεύεται έναν άλλο. και γάμους με βάση την πολυγαμία (σύζυγοι) ή ομαδικούς γάμους. Στην πολυγαμία (σύζυγος).	Cultural Identity	el	11.0
Θρησκευτικές και κοσμικές προσδοκίες γάμου και σεξουαλικότητας\nΜε την πάροδο του χρόνου, οι ιστορίες και οι παραδοσιακοί πολιτισμοί που γράφτηκαν από τους Bachofen και Morgan, μεταξύ άλλων, έπεσαν σταδιακά θύματα της ομογενοποίησης που επέβαλε η αποικιοκρατία.	Cultural Identity	el	11.0
Διεθνείς οργανισμοί, συμπεριλαμβανομένων των Ηνωμένων Εθνών, έχουν εκδώσει ψηφίσματα που υποστηρίζουν τα δικαιώματα LGBTQ+, αλλά οι ομάδες ανθρωπίνων δικαιωμάτων λένε ότι έχουν περιορισμένες εξουσίες για την επιβολή τους.	Fairness and Equality	el	4.0
Εν τω μεταξύ, στην ημιαυτόνομη δημοκρατία της Ρωσίας της Τσετσενίας, δεκάδες άνδρες που είναι ύποπτοι για ομοφυλόφιλους έχουν συλληφθεί, βασανιστεί και σκοτωθεί σε δύο ξεχωριστές επίσημες επιδρομές από το 2017.	Fairness and Equality	el	4.0
Νομοθέτες στην Ταϊλάνδη και το Βιετνάμ εξετάζουν νομοσχέδια που θα νομιμοποιούν τους γάμους ομοφυλοφίλων ή τις συμβίωσης.	Fairness and Equality	el	4.0
Η υποστήριξη για τη νομιμοποίηση του γάμου ομοφύλων είναι επίσης χαμηλότερη στην Καραϊβική, με 16 τοις εκατό στην Τζαμάικα και 23 τοις εκατό στη Δομινικανή Δημοκρατία, σύμφωνα με την ILGA.	Fairness and Equality	el	4.0
Οι νομικές σχέσεις συζύγων, γονέων και παιδιών έτειναν επίσης να αλληλεπικαλύπτονται σε ομάδες όπου ο γάμος μεταξύ ατόμων του ιδίου φύλου ήταν εξαιρετικά προβληματικός.	Health and Safety	el	9.0
Σε αντίθεση με το αφυπνιστικό μοντέλο του γάμου, οι υποστηρικτές του νομιμοποιημένου γάμου ομοφύλων πιστεύουν συχνά ότι οι αφοσιωμένες συνεργασίες που περιλαμβάνουν σεξουαλική οικειότητα είναι πολύτιμες επειδή φέρνουν τους ανθρώπους κοντά με μοναδικούς και μοναδικούς τρόπους.	Health and Safety	el	9.0
Ορισμένες άλλες χώρες έχουν ισλαμικά συντάγματα που συχνά ερμηνεύονται ως απαγορεύσεις σε ζευγάρια του ίδιου φύλου να παντρεύονται.	Legality, Constitutionality, Jurisdiction	el	5.0
Στις Ηνωμένες Πολιτείες, ο γάμος ομοφυλόφιλων έγινε το επίσημο αίτημα του κινήματος για τα δικαιώματα των ομοφυλοφίλων μετά τη δεύτερη εθνική πορεία για τα δικαιώματα των ομοφυλοφίλων στην Ουάσιγκτον το 1987.	Legality, Constitutionality, Jurisdiction	el	5.0
Σε άλλες χώρες, υπάρχει μια γλώσσα στα εγκριθέντα συντάγματα που αναφέρει ότι ο γάμος γίνεται μεταξύ άνδρα και γυναίκας, ενώ δεν υπάρχει γλώσσα που να απαγορεύει τον γάμο ομοφύλων, ειδικά σε παλαιότερα συντάγματα.	Legality, Constitutionality, Jurisdiction	el	5.0
Είπαν επίσης ότι είναι απαράδεκτο και εισάγει διακρίσεις η αντικατάσταση του γάμου μεταξύ ατόμων του ιδίου φύλου με χωριστούς νόμους, όπως οι συμβίωση.	Legality, Constitutionality, Jurisdiction	el	5.0
Παρά το γεγονός ότι είναι σχετικά ξεχωριστά, ορισμένα πρακτορεία αναγνωρίζουν πλήρως τις συνεργασίες μεταξύ ατόμων του ίδιου φύλου.	Legality, Constitutionality, Jurisdiction	el	5.0
Αν και ο γάμος ομοφυλόφιλων ρυθμίζεται από νόμο, θρησκεία και παράδοση στις περισσότερες χώρες του κόσμου, οι νομικές και κοινωνικές αντιδράσεις ποικίλλουν από τον εορτασμό αφενός έως την ποινικοποίηση αφετέρου.	Morality	el	3.0
Στα τέλη του 20ου και στις αρχές του 21ου αιώνα, οι απόψεις μιας ή περισσότερων θρησκειών του κόσμου (Βουδισμός, Ινδουισμός, Ιουδαϊσμός, Ισλάμ και Χριστιανισμός) και οι αντίστοιχες πρακτικές του αστικού δικαίου αναφέρονταν συχνά σε εθνικές συζητήσεις για τους γάμους ομοφύλων.	Morality	el	3.0
Ακόμη και στο Ιράν, όπου οι ισχυρές μουσουλμανικές θρησκευτικές πεποιθήσεις ποινικοποιούν την ομοφυλοφιλία, ακόμη και στη Δανία, όπου τα αποτελέσματα από μια διάσκεψη Ευαγγελικών Λουθηρανών επισκόπων (που εκπροσωπούν την κρατική θρησκεία) ανοίγουν το δρόμο για το πρώτο επίπεδο εθνικής αναγνώρισης. Σχέσεις μεταξύ ατόμων του ιδίου φύλου μέσω καταχωρημένων συνεργασιών.	Morality	el	3.0
Σε άλλες περιπτώσεις, η πολιτισμική ομοιογένεια που προωθείται από την κυρίαρχη θρησκεία δεν μετέφερε την αρχή στην πολιτική σφαίρα, αν και πυροδότησε μια ευαίσθητη συζήτηση μεταξύ των πολιτών: για παράδειγμα, στο Βέλγιο και την Ισπανία, η νομιμοποίηση της ομοφυλοφιλίας έρχεται στο γάμο; Θρησκευτική οργάνωση, Ρωμαιοκαθολική Εκκλησία.	Morality	el	3.0
Αλλά το Roe του Ανωτάτου Δικαστηρίου v. Η απόφαση του Γουέιντ έχει εγείρει νέες ανησυχίες ότι το ανώτατο δικαστήριο της χώρας θα επανεξετάσει άλλα δικαιώματα που σχετίζονται με την ισότητα του γάμου. .	Other	el	15.0
"Οι λέξεις ""κανένα σχέδιο για τα επόμενα χρόνια"" αντιπροσωπεύουν μια εκπληκτική προσωπική εξέλιξη για τον επί μακρόν κάτοικο της Ουάσινγκτον, η επιμονή του Μπάιντεν ως γερουσιαστής ψήφισε να εμποδίσει την ομοσπονδιακή κυβέρνηση να αναγνωρίσει τους γάμους ομοφυλοφίλων, κάτι που προηγουμένως είχε μόνο ισχυριστεί. Μέσα. Η κατάσταση μεταξύ ανδρών και γυναικών."	Other	el	15.0
Υπάρχει ακόμα βία και μίσος. Βιβλία με θέματα LGBTQ και χαρακτήρες για τα τρανς δικαιώματα, τους τρανς αθλητές, την υγειονομική περίθαλψη που επιβεβαιώνει το φύλο και τα σχολεία για τρανς νέους.	Policy Prescription and Evaluation	el	6.0
Οι οπορτουνιστές δεξιοί πολιτικοί αποκτούν εξουσία ενσταλάσσοντας αβάσιμο φόβο στις περιθωριοποιημένες κοινότητες που παρεξηγούν αυτά τα ζητήματα και στη συνέχεια προστατεύονται από τους στόχους τους.	Policy Prescription and Evaluation	el	6.0
Ο Sasha Isenberg, συγγραφέας του Engagement: America's Quarter Same, δήλωσε: «Ως προεδρικός υποψήφιος και αντιπρόεδρος στη Γερουσία, ήταν πάντα επιφυλακτικός για τα ζητήματα LGBT και φοβόταν να πάρει οποιαδήποτε θέση θα μπορούσαν να χρησιμοποιήσουν οι αντίπαλοί του για να τον παρουσιάσουν ως αριστερό». -Ο εκατονταετής πόλεμος στον σεξουαλικό γάμο, ανέφερε το CNN.	Policy Prescription and Evaluation	el	6.0
Judith Carson-Windsor, σύζυγος του ακτιβιστή για τα δικαιώματα των ομοφυλοφίλων Eddie Windsor. Ο Μάθιου Χέινς, συνιδιοκτήτης του Club Q, ενός κλαμπ LGBTQ στο Κολοράντο Σπρινγκς, σκοτώθηκε από έναν ένοπλο σε μαζικό πυροβολισμό τον περασμένο μήνα. 5; Ο James Sloah, ο οποίος επέζησε από τον πυροβολισμό Club Q. και Michael Anderson? Αρκετοί ενάγοντες στην υπόθεση ορόσημο για τα πολιτικά δικαιώματα του Obergefell v Hodges, η οποία αποφάσισε το 2015 ότι τα ομόφυλα ζευγάρια μπορούν να παντρευτούν σε εθνικό επίπεδο.	Policy Prescription and Evaluation	el	6.0
Η Βουλή των Αντιπροσώπων ψήφισε νομοθεσία την Πέμπτη που προστατεύει τους γάμους ομοφυλόφιλων και διαφυλετικών. Αυτό είναι το τελευταίο βήμα πριν το νομοσχέδιο πάει στον Πρόεδρο Τζο Μπάιντεν για υπογραφή και γίνει νόμος.	Policy Prescription and Evaluation	el	6.0
Ο πρόεδρος Τζο Μπάιντεν υπέγραψε την Τρίτη ιστορικές νέες ομοσπονδιακές προστασίες για ομόφυλα και μικτά ζευγάρια, περιορίζοντας τις ατομικές και εθνικές εξελίξεις σε ένα ζήτημα που έχει γίνει πιο αποδεκτό την τελευταία δεκαετία.	Political	el	13.0
Ο Μπάιντεν υπέγραψε τον νόμο για τις τιμές του γάμου μπροστά σε χιλιάδες προσκεκλημένους στο South Lawn, κάτι που σύμφωνα με τον Λευκό Οίκο αντανακλά τη σημασία της στιγμής.	Political	el	13.0
Ενώ η κοινή γνώμη για τους γάμους ομοφυλόφιλων παρουσιάζει διακυμάνσεις με τα χρόνια, ένα τέτοιο νομοσχέδιο φαίνεται απίθανο να ψηφιστεί στην Ουάσιγκτον: Σύμφωνα με μια μη κερδοσκοπική έρευνα, το 68 τοις εκατό των Αμερικανών υποστηρίζει τους γάμους ομοφυλόφιλων το 2021, σύμφωνα με το 2014. Υπήρξε μια αύξηση 14 τοις εκατό στη δημόσια θρησκεία πέρυσι.	Political	el	13.0
"Οι λέξεις ""κανένα σχέδιο για τα επόμενα χρόνια"" αντιπροσωπεύουν μια εκπληκτική προσωπική εξέλιξη για τον επί μακρόν κάτοικο της Ουάσινγκτον, η επιμονή του Μπάιντεν ως γερουσιαστής ψήφισε να εμποδίσει την ομοσπονδιακή κυβέρνηση να αναγνωρίσει τους γάμους ομοφυλοφίλων, κάτι που προηγουμένως είχε μόνο ισχυριστεί. Μέσα. Η κατάσταση μεταξύ ανδρών και γυναικών."	Political	el	13.0
«Βλέπετε, χθες υπήρχε πολύ καλή δικομματική υποστήριξη στη Βουλή και ελπίζω να τη δείτε στη Γερουσία», είπε.	Political	el	13.0
Σχεδόν οι μισοί (51%) από όσους έχουν λιγότερη εκπαίδευση από το γυμνάσιο λένε ότι ο γάμος μεταξύ ατόμων του ιδίου φύλου είναι πολύ καλός (26%) ή κάπως καλός (25%) για την κοινωνία, ενώ το 45% (20%) λέει ότι δεν είναι. Πολύ κακό (24%).	Public Sentiment	el	12.0
Ενώ οι κομματικές διαφορές είναι έντονες ανεξάρτητα από την ηλικία και το μορφωτικό υπόβαθρο των Αμερικανών, αυτές οι διαφορές είναι πιο μέτριες μεταξύ των νεότερων ενηλίκων από τους ηλικιωμένους.	Public Sentiment	el	12.0
Οι νεότεροι Ρεπουμπλικάνοι εξέφρασαν πιο θετικές απόψεις για τους γάμους ομοφύλων από τους μεγαλύτερους Ρεπουμπλικάνους, ενώ η διαφορά ηλικίας ήταν λιγότερο έντονη μεταξύ των Δημοκρατικών.	Public Sentiment	el	12.0
Το χάσμα στην εκπαίδευση είναι ελαφρώς μεγαλύτερο για τους Δημοκρατικούς από ότι για τους Ρεπουμπλικάνους.	Public Sentiment	el	12.0
Ακόμη και δημοκρατικοί υψηλού προφίλ, όπως ο πρώην πρόεδρος Μπαράκ Ομπάμα, ήταν απρόθυμοι να μοιραστούν την υποστήριξή τους στους γάμους ομοφυλοφίλων – ο Ομπάμα τελικά έγινε ο πρώτος πρόεδρος που το έκανε.	Public Sentiment	el	12.0
Ενώ η υποστήριξη για τον γάμο μεταξύ ατόμων του ιδίου φύλου έχει αυξηθεί από γενιά σε γενιά τα τελευταία 15 χρόνια, η διαφορά ηλικίας εξακολουθεί να είναι μεγάλη.	Quality of Life	el	10.0
Για παράδειγμα, το 45 τοις εκατό των ενηλίκων της Silent Generation (γεννημένοι μεταξύ 1928 και 1945) επιτρέπουν τον γάμο ομοφύλων, ενώ το 74 τοις εκατό των millennials (γεννημένοι μεταξύ 1981 και 1996) επιτρέπουν τον γάμο ομοφύλων.	Quality of Life	el	10.0
Μια δημοσκόπηση του 2017 της Gallup διαπίστωσε ότι ένας στους 10 ΛΟΑΤ Αμερικανούς (10,2%) είχε παντρευτεί σύντροφο του ιδίου φύλου τους μήνες (7,9%) πριν από την απόφαση του ανώτατου δικαστηρίου.	Quality of Life	el	10.0
Μια νέα δημοσκόπηση που διεξήχθη ενόψει των ενδιάμεσων εκλογών τον Οκτώβριο έδειξε ότι το Ανώτατο Δικαστήριο τον Ιούνιο Roe v. Αφού ο Γουέιντ ανέτρεψε την απόφασή του, έθεσε ορισμένα ερωτήματα σχετικά με το εάν ο γάμος ομοφύλων είναι νόμιμος σε ολόκληρη τη χώρα. Οι νόμοι για τις αμβλώσεις επιστρέφουν στις πολιτείες.	Quality of Life	el	10.0
Το Ερευνητικό Κέντρο Pew έθεσε ερωτήσεις για να μετρήσει την κοινή γνώμη σχετικά με το νομικό καθεστώς του γάμου ομοφύλων.	Quality of Life	el	10.0
Απαιτεί από τα κράτη να τηρούν την ισχύ των αδειών γάμου εκτός πολιτείας, συμπεριλαμβανομένων των ομοφυλοφίλων και των πολυφυλετικών συμπράξεων.	Security and Defense	el	8.0
«Το κυνήγι της ευτυχίας είναι να μπορείς να αγαπάς όποιον θέλεις», είπε.	Security and Defense	el	8.0
Διευκρινίζει ότι τα θρησκευτικά ιδρύματα δεν επιβάλλουν τους γάμους ομοφυλόφιλων και ότι η κυβέρνηση δεν μπορεί να τους αναγκάσει να προστατεύσουν την πολυγαμία.	Security and Defense	el	8.0
Η Βουλή των Αντιπροσώπων ψήφισε νομοθεσία την Τρίτη για τη νομιμοποίηση των γάμων ομοφύλων σε εθνικό επίπεδο και την ενίσχυση άλλων προστασιών για την ισότητα του γάμου, ως άμεση απάντηση στην πρόσφατη απόφαση του Ανωτάτου Δικαστηρίου που έχει αφαιρέσει από καιρό τα κρατικά δικαιώματα άμβλωσης.	Security and Defense	el	8.0
Αφενός, ο σκοπός του γάμου είναι να διασφαλίσει ότι η τεκνοποίηση και η ανατροφή των παιδιών προχωρούν ομαλά.	Quality of Life	el	10.0
