sentence	label_name	Language	label_ID
Il matrimonio tra persone dello stesso sesso ha effetti economici positivi, come B. aumento del reddito da turisti e permessi di matrimonio e spese legate al matrimonio.	Economic	it	1.0
Gli oppositori del matrimonio tra persone dello stesso sesso sostengono che porterà a conseguenze economiche negative, come l'indebolimento delle strutture familiari tradizionali e la conseguente instabilità sociale.	Economic	it	1.0
Legalizzare il matrimonio tra persone dello stesso sesso aiuterebbe le coppie dello stesso sesso ad accedere alle stesse risorse e benefici delle coppie eterosessuali, come b. Diritti sanitari e diritti successori	Capacity and Resources	it	2.0
Alcuni oppositori del matrimonio tra persone dello stesso sesso sostengono che ciò indebolirebbe la capacità delle agenzie e delle istituzioni governative di riconoscere e riconoscere i matrimoni tra persone dello stesso sesso.	Capacity and Resources	it	2.0
I sostenitori del matrimonio tra persone dello stesso sesso sostengono che si tratta di un diritto umano fondamentale e che negare alle coppie dello stesso sesso il diritto di sposarsi è moralmente sbagliato.	Morality	it	3.0
Gli oppositori del matrimonio tra persone dello stesso sesso spesso basano le loro argomentazioni su motivi religiosi o morali, sostenendo che il matrimonio dovrebbe essere solo tra un uomo e una donna.	Morality	it	3.0
La legalizzazione del matrimonio tra persone dello stesso sesso è spesso vista come una questione di giustizia e uguaglianza, in quanto offre alle coppie dello stesso sesso lo stesso riconoscimento legale e gli stessi vantaggi delle coppie eterosessuali.	Fairness and Equality	it	4.0
Gli oppositori del matrimonio tra persone dello stesso sesso sostengono che non è uguaglianza perché le coppie dello stesso sesso possono entrare in unioni registrate o dello stesso sesso, che danno loro gli stessi diritti legali delle coppie sposate.	Fairness and Equality	it	4.0
Lo status legale del matrimonio tra persone dello stesso sesso varia a seconda della giurisdizione. Alcuni paesi e stati lo legalizzano mentre altri no. Ciò ha acceso il dibattito su questioni come i diritti degli stati e il ruolo del governo federale nella definizione del matrimonio.	Legality, Constitutionality, Jurisdiction	it	5.0
Gli oppositori del matrimonio tra persone dello stesso sesso in genere sostengono che spetta agli stati decidere se legalizzarlo o meno, mentre i sostenitori in genere sostengono che si tratta di una questione di diritti costituzionali federali.	Legality, Constitutionality, Jurisdiction	it	5.0
I sostenitori del matrimonio tra persone dello stesso sesso vedono la legalizzazione del matrimonio tra persone dello stesso sesso come un passo politico positivo verso una maggiore uguaglianza e inclusione.	Policy Prescription and Evaluation	it	6.0
Gli oppositori del matrimonio tra persone dello stesso sesso sostengono che ha conseguenze sociali e culturali negative e non fornisce una soluzione politica praticabile ai problemi che devono affrontare le coppie dello stesso sesso.	Policy Prescription and Evaluation	it	6.0
La legalizzazione del matrimonio tra persone dello stesso sesso non ha conseguenze penali o penali.	Crime and Punishment	it	7.0
Tuttavia, gli oppositori del matrimonio tra persone dello stesso sesso spesso sostengono che distruggerà i valori familiari tradizionali e gli standard morali, che secondo loro avranno conseguenze sociali negative.	Crime and Punishment	it	7.0
La legalizzazione del matrimonio tra persone dello stesso sesso non ha implicazioni inerenti alla sicurezza o alla sicurezza.	Security and Defense	it	8.0
Ma alcuni oppositori del matrimonio tra persone dello stesso sesso affermano che mina le strutture familiari tradizionali, che secondo loro sono essenziali per valori sociali forti e per la difesa nazionale.	Security and Defense	it	8.0
La legalizzazione del matrimonio tra persone dello stesso sesso ha avuto un impatto positivo sulla salute e sulla sicurezza fornendo alle coppie dello stesso sesso l'accesso a importanti benefici legali e medici come l'assicurazione sanitaria e il diritto alle visite ospedaliere.	Health and Safety	it	9.0
Gli oppositori del matrimonio tra persone dello stesso sesso sostengono che può avere conseguenze negative sulla salute, tra cui:	Health and Safety	it	9.0
La legalizzazione del matrimonio tra persone dello stesso sesso avrebbe un impatto positivo sulla qualità della vita delle coppie dello stesso sesso, fornendo un maggiore riconoscimento legale e l'accesso a importanti benefici e risorse.	Quality of Life	it	10.0
Gli oppositori del matrimonio tra persone dello stesso sesso spesso sostengono che sconvolge le strutture e i valori familiari tradizionali, influenzando negativamente la qualità della vita degli individui e delle famiglie.	Quality of Life	it	10.0
Il matrimonio tra persone dello stesso sesso può essere visto come un riflesso del cambiamento degli atteggiamenti culturali nei confronti dei diritti e dell'accettazione LGBTQ+.	Cultural Identity	it	11.0
Gli oppositori del matrimonio tra persone dello stesso sesso discutono spesso della conservazione dei valori e delle norme culturali tradizionali.	Cultural Identity	it	11.0
L'opinione pubblica sul matrimonio tra persone dello stesso sesso è cambiata radicalmente negli ultimi anni, con un crescente sostegno al riconoscimento legale delle relazioni tra persone dello stesso sesso.	Public Sentiment	it	12.0
Tuttavia, alcuni oppositori del matrimonio tra persone dello stesso sesso sostengono che l'opinione pubblica non dovrebbe influenzare le decisioni politiche e che il matrimonio dovrebbe essere definito come tra un uomo e una donna.	Public Sentiment	it	12.0
Il matrimonio tra persone dello stesso sesso è una questione altamente politica, con diversi partiti politici e gruppi di interesse che assumono posizioni diverse sulla questione.	Political	it	13.0
La legalità del matrimonio tra persone dello stesso sesso diventa spesso una questione politica durante le elezioni, poiché i candidati commentano sulle loro piattaforme.	Political	it	13.0
Lo status giuridico del matrimonio tra persone dello stesso sesso può influire sulla posizione internazionale di un paese, in particolare nella sua posizione sui diritti umani e sulle questioni LGBTQ+.	External Regulation and Reputation	it	14.0
Alcuni oppositori del matrimonio tra persone dello stesso sesso sostengono che danneggi l'immagine del Paese e le sue relazioni con altri Paesi.	External Regulation and Reputation	it	14.0
Il matrimonio tra persone dello stesso sesso è legato a molte altre questioni, come l'adozione e la custodia dei figli, la discriminazione e i crimini di odio e le disparità di salute.	Other	it	15.0
Il dibattito sul matrimonio tra persone dello stesso sesso è complesso e sfaccettato e spesso coinvolge diversi gruppi di interesse e punti di vista.	Other	it	15.0
L'immigrazione ha effetti sia positivi che negativi sull'economia, sebbene contribuisca all'economia attraverso l'occupazione e il consumo, consuma anche risorse pubbliche.	Economic	it	1.0
Alcuni sostengono che l'immigrazione sia necessaria per la crescita economica, specialmente nei settori a scarsità di manodopera, mentre altri sostengono che causi la perdita del lavoro da parte dei lavoratori locali.	Economic	it	1.0
La migrazione mette sotto pressione le risorse pubbliche come la sanità, l'istruzione e l'alloggio, specialmente nelle aree con una grande popolazione di migranti.	Capacity and Resources	it	2.0
Ma alcuni sostengono che gli immigrati portino anche competenze e abilità che vanno a beneficio della società e contribuiscono allo sviluppo di queste risorse.	Capacity and Resources	it	2.0
La moralità dell'immigrazione è una questione controversa, con alcuni che sostengono che sia un imperativo morale fornire protezione e opportunità a chi ne ha bisogno, mentre altri ritengono che sia immorale consentire agli immigrati privi di documenti di rimanere nel paese.	Morality	it	3.0
Il dibattito sull'immigrazione ruota spesso attorno a questioni di giustizia e uguaglianza. Alcuni sostengono che non sia giusto dare la priorità ai bisogni degli immigrati rispetto a quelli dei cittadini nativi, mentre altri sostengono che gli immigrati dovrebbero avere pari opportunità indipendentemente dalla nazionalità.	Fairness and Equality	it	4.0
La legalità dell'immigrazione è una questione complessa con leggi e regolamenti diversi che disciplinano diversi tipi di immigrazione e visti.	Legality, Constitutionality, Jurisdiction	it	5.0
Alcuni ritengono che la politica sull'immigrazione sia incostituzionale o ingiusta, mentre altri ritengono che sia importante far rispettare e proteggere la sicurezza nazionale.	Legality, Constitutionality, Jurisdiction	it	5.0
L'efficacia di varie politiche e programmi di immigrazione è un dibattito in corso poiché diverse parti interessate propongono soluzioni diverse alle sfide e alle opportunità dell'immigrazione.	Policy Prescription and Evaluation	it	6.0
La valutazione è importante per garantire che le politiche ei programmi di immigrazione siano efficaci ed equi.	Policy Prescription and Evaluation	it	6.0
Il rapporto tra immigrazione e criminalità è controverso, con alcuni che sostengono che gli immigrati hanno maggiori probabilità di commettere reati e rappresentano una minaccia per la sicurezza pubblica, mentre altri sostengono che gli immigrati hanno meno probabilità di commettere reati rispetto ai cittadini nativi.	Crime and Punishment	it	7.0
L'immigrazione ha implicazioni per la sicurezza nazionale e la sicurezza nazionale, in particolare lo screening e il controllo degli immigrati e la prevenzione dell'ingresso di potenziali minacce.	Security and Defense	it	8.0
Ma alcuni sostengono che politiche di immigrazione eccessivamente restrittive possano danneggiare le relazioni con altri paesi e limitare le opportunità di cooperazione e innovazione.	Security and Defense	it	8.0
La migrazione ha implicazioni per la salute pubblica e la sicurezza, in particolare in termini di diffusione di malattie e accesso all'assistenza sanitaria.	Health and Safety	it	9.0
Tuttavia, alcuni sostengono che la fornitura di assistenza sanitaria e servizi sociali può migliorare i risultati generali della salute pubblica e ridurre la pressione sui servizi di emergenza.	Health and Safety	it	9.0
La migrazione può avere effetti positivi e negativi sulla qualità della vita sia dei migranti che dei cittadini autoctoni, a seconda di fattori quali lo status economico, la coesione sociale e l'identità culturale.	Quality of Life	it	10.0
Alcuni sostengono che l'immigrazione promuova la diversità e lo scambio culturale, mentre altri credono che abbia portato alla divisione sociale ed economica.	Quality of Life	it	10.0
La migrazione influisce sull'identità culturale, soprattutto in termini di lingua, tradizioni e valori.	Cultural Identity	it	11.0
Alcuni sostengono che l'immigrazione possa arricchire e diversificare l'esperienza culturale, mentre altri sostengono che possa erodere l'identità nazionale e la coesione sociale.	Cultural Identity	it	11.0
L'opinione pubblica sull'immigrazione è stata polarizzata, con alcuni che esprimono sostegno per una maggiore immigrazione, altri che chiedono maggiori controlli e restrizioni.	Public Sentiment	it	12.0
Il modo in cui i media ei politici ritraggono gli immigrati può influenzare l'opinione pubblica e le decisioni politiche.	Public Sentiment	it	12.0
L'immigrazione è una questione altamente politica, con diversi partiti politici e gruppi di interesse che assumono posizioni diverse sulla questione.	Political	it	13.0
Il dibattito sull'immigrazione diventa spesso una questione politica durante le elezioni, con i candidati che prendono posizione sulla questione nelle proprie piattaforme.	Political	it	13.0
Il modo in cui un paese gestisce l'immigrazione può influire sulla sua reputazione e sulle relazioni con altri paesi, soprattutto quando si tratta di diritti umani e diritto internazionale.	External Regulation and Reputation	it	14.0
I modelli migratori sono influenzati anche dalle pressioni esterne e dalle regole delle organizzazioni e dei trattati internazionali.	External Regulation and Reputation	it	14.0
Altre questioni relative all'immigrazione includono l'impatto sulle dinamiche familiari, il ruolo degli immigrati nel plasmare le tendenze della popolazione e lo scambio culturale e l'integrazione degli immigrati nella società.	Other	it	15.0
Questi temi hanno un impatto significativo sulle dinamiche sociali, economiche e politiche del Paese.	Other	it	15.0
Il matrimonio tra persone dello stesso sesso può avere un impatto economico positivo aumentando gli affari e il turismo locali e aumentando le entrate fiscali statali.	Economic	it	1.0
Gli oppositori affermano che il matrimonio tra persone dello stesso sesso sconvolge il matrimonio tradizionale e le strutture familiari e ha un impatto negativo sull'economia.	Economic	it	1.0
La legalizzazione del matrimonio tra persone dello stesso sesso aumenterebbe l'accesso delle coppie dello stesso sesso a risorse e benefici come l'assistenza sanitaria e i diritti dei genitori.	Capacity and Resources	it	2.0
I critici sostengono che il matrimonio tra persone dello stesso sesso richiede risorse e potere perché richiede cambiamenti nei quadri giuridici e nelle istituzioni.	Capacity and Resources	it	2.0
I fautori del matrimonio tra persone dello stesso sesso sostengono che riconoscere la parità di diritti e dignità di tutte le persone indipendentemente dall'orientamento sessuale è un imperativo morale.	Morality	it	3.0
Gli oppositori sostengono che il matrimonio tra persone dello stesso sesso è immorale e viola i valori religiosi e culturali tradizionali.	Morality	it	3.0
Il matrimonio tra persone dello stesso sesso è considerato un'importante questione di giustizia e uguaglianza per le persone LGBTQ+, poiché offre gli stessi diritti e tutele legali delle coppie eterosessuali.	Fairness and Equality	it	4.0
I critici sostengono che il matrimonio tra persone dello stesso sesso non è una questione di uguaglianza perché richiede una ridefinizione della definizione tradizionale di matrimonio.	Fairness and Equality	it	4.0
La legalità del matrimonio tra persone dello stesso sesso è stata discussa con tribunali e governi che differiscono nell'interpretazione costituzionale e nell'opinione giudiziaria	Legality, Constitutionality, Jurisdiction	it	5.0
Gli oppositori sostengono che il matrimonio tra persone dello stesso sesso non dovrebbe essere legalizzato perché né la Costituzione né il precedente impongono chiaramente il matrimonio tra persone dello stesso sesso.	Legality, Constitutionality, Jurisdiction	it	5.0
Le impostazioni della politica sul matrimonio tra persone dello stesso sesso variano a seconda di fattori politici e culturali. Alcuni paesi lo legalizzano mentre altri lo vietano.	Policy Prescription and Evaluation	it	6.0
La valutazione dell'impatto sociale e personale del matrimonio tra persone dello stesso sesso è un processo continuo, con ricerche che mostrano risultati sia positivi che negativi.	Policy Prescription and Evaluation	it	6.0
Alcune giurisdizioni criminalizzano il matrimonio tra persone dello stesso sesso e gli individui devono affrontare sanzioni legali o giudizi sociali per le relazioni tra persone dello stesso sesso.	Crime and Punishment	it	7.0
Gli sforzi per legalizzare il matrimonio tra persone dello stesso sesso sono spesso visti come un modo per porre fine alla discriminazione e alla punizione basate sull'orientamento sessuale.	Crime and Punishment	it	7.0
Il matrimonio tra persone dello stesso sesso è stato utilizzato come strumento per far avanzare i programmi di sicurezza nazionale e diritti umani, in particolare nel contesto delle relazioni internazionali e della diplomazia.	Security and Defense	it	8.0
I critici ritengono che il matrimonio tra persone dello stesso sesso mina l'istituzione del matrimonio e della famiglia e influenzi negativamente la sicurezza nazionale e la stabilità sociale.	Security and Defense	it	8.0
La legalizzazione del matrimonio tra persone dello stesso sesso può migliorare la salute e la sicurezza delle persone LGBTQ+ dando loro accesso all'assistenza sanitaria, all'assicurazione e alla protezione legale.	Health and Safety	it	9.0
Gli oppositori affermano che il matrimonio tra persone dello stesso sesso è dannoso per la salute individuale e pubblica, portando alla diffusione di malattie e altri esiti negativi.	Health and Safety	it	9.0
A causa del riconoscimento legale e sociale di LGBTQ+, il matrimonio tra persone dello stesso sesso è considerato un fattore importante per migliorare la qualità della vita delle persone LGBTQ+.	Quality of Life	it	10.0
I critici sostengono che il matrimonio tra persone dello stesso sesso mina i valori e le strutture tradizionali, influenzando negativamente la qualità della vita degli individui e delle società.	Quality of Life	it	10.0
Il matrimonio tra persone dello stesso sesso è considerato una questione centrale dell'identità culturale LGBTQ+, in quanto rappresenta un riconoscimento fondamentale della loro esistenza e dei loro diritti nella società.	Cultural Identity	it	11.0
Gli oppositori sostengono che il matrimonio tra persone dello stesso sesso minaccia le identità e i valori culturali tradizionali e potrebbe portare al degrado sociale e morale.	Cultural Identity	it	11.0
Nel corso del tempo, l'opinione pubblica sul matrimonio tra persone dello stesso sesso si è evoluta e sempre più paesi e territori accettano e sostengono il matrimonio tra persone dello stesso sesso.	Public Sentiment	it	12.0
La spinta a legalizzare il matrimonio tra persone dello stesso sesso è spesso guidata dal sentimento pubblico, con politici e organizzazioni che rispondono al cambiamento di atteggiamenti e idee.	Public Sentiment	it	12.0
La questione del matrimonio tra persone dello stesso sesso è spesso politica, con partiti politici e politici che assumono posizioni diverse a seconda dei loro valori e ideologie.	Political	it	13.0
La legalizzazione del matrimonio tra persone dello stesso sesso è diventata una questione politica importante per gli attivisti per i diritti LGBTQ+, che la vedono come un modo per raggiungere una maggiore uguaglianza sociale e legale.	Political	it	13.0
Il matrimonio tra persone dello stesso sesso è spesso visto come una misura dell'impegno del paese per il progresso sociale e i diritti umani, ma gruppi e alleati internazionali stanno facendo pressione sul governo per legalizzarlo.	External Regulation and Reputation	it	14.0
Gli oppositori sostengono che la pressione esterna per legalizzare il matrimonio tra persone dello stesso sesso viola la sovranità nazionale ei valori culturali.	External Regulation and Reputation	it	14.0
Il matrimonio tra persone dello stesso sesso è una questione molto controversa ed emotiva in cui individui e gruppi di entrambe le parti combattono per le proprie convinzioni e valori.	Other	it	15.0
Il dibattito sul matrimonio tra persone dello stesso sesso è complesso e sfaccettato e riflette tensioni sociali e culturali più ampie intorno all'identità, ai valori e al potere.	Other	it	15.0
L'immigrazione ha effetti economici sia positivi che negativi, con alcuni che sostengono che porti manodopera e competenze preziose, mentre altri sostengono che abbassi i salari e danneggi i servizi sociali.	Economic	it	1.0
Molte aziende si affidano a lavoratori migranti, soprattutto in settori come l'agricoltura, l'ospitalità e l'edilizia.	Economic	it	1.0
La migrazione mette sotto pressione le infrastrutture e le risorse di un paese, come l'alloggio, i trasporti e l'assistenza sanitaria, soprattutto nelle aree con un'elevata domanda di servizi.	Capacity and Resources	it	2.0
Molti paesi limitano il numero di immigrati che possono accettare in base alle loro risorse e alla capacità di fornire assistenza.	Capacity and Resources	it	2.0
Alcuni vedono l'immigrazione come un obbligo morale per aiutare i bisognosi, in particolare i rifugiati in fuga da violenze o persecuzioni nei loro paesi d'origine.	Morality	it	3.0
Altri sostengono che consentire agli immigrati di entrare illegalmente o sfruttare i lavoratori migranti non è etico.	Morality	it	3.0
Molti sostengono che la politica dell'immigrazione dovrebbe basarsi sui principi di giustizia e uguaglianza e che gli immigrati dovrebbero essere trattati con dignità e rispetto.	Fairness and Equality	it	4.0
Altri sostengono che dare la priorità agli immigrati rispetto ai cittadini sia ingiusto e ingiusto.	Fairness and Equality	it	4.0
La politica di immigrazione deve affrontare sfide legali e costituzionali, in particolare in materia di cittadinanza, espulsione e asilo.	Legality, Constitutionality, Jurisdiction	it	5.0
Molti paesi hanno differenze giurisdizionali, con governi locali, statali e federali che svolgono un ruolo nella politica sull'immigrazione.	Legality, Constitutionality, Jurisdiction	it	5.0
La politica dell'immigrazione è spesso determinata dalla formulazione e dalla valutazione delle politiche, in cui esperti e responsabili politici soppesano i costi ei benefici dei diversi approcci.	Policy Prescription and Evaluation	it	6.0
Alcuni sostengono che la strategia dovrebbe essere basata su prove e dati, mentre altri enfatizzano ragioni teoriche o politiche.	Policy Prescription and Evaluation	it	6.0
La politica sull'immigrazione è spesso collegata a questioni di criminalità e punizione, e alcuni sostengono che gli immigrati hanno maggiori probabilità di commettere reati e dovrebbero essere soggetti a un'applicazione più rigorosa.	Crime and Punishment	it	7.0
Altri sostengono che gli immigrati sono presi di mira ingiustamente e che le politiche dovrebbero concentrarsi sulla riduzione della criminalità e sul miglioramento della sicurezza pubblica per tutti i residenti.	Crime and Punishment	it	7.0
La politica dell'immigrazione influisce sulla sicurezza e sulla difesa del paese, in particolare in relazione alle questioni del controllo delle frontiere e dell'identità nazionale.	Security and Defense	it	8.0
Alcuni vedono l'immigrazione come una minaccia alla sicurezza nazionale, mentre altri la considerano necessaria per mantenere una società pluralistica e multiculturale.	Security and Defense	it	8.0
La politica di immigrazione ha implicazioni per la salute pubblica e la sicurezza, in particolare per quanto riguarda il controllo delle malattie e le questioni di risposta alle emergenze.	Health and Safety	it	9.0
Alcuni sostengono che la politica sull'immigrazione dovrebbe dare la priorità alla salute e alla sicurezza pubblica, mentre altri sostengono che la politica dovrebbe dare la priorità ai bisogni di immigrati e rifugiati.	Health and Safety	it	9.0
Le politiche di immigrazione influiscono sulla qualità della vita degli immigrati e dei cittadini, in particolare in termini di coesione sociale, istruzione e occupazione.	Quality of Life	it	10.0
Alcuni sostengono che l'immigrazione migliori la qualità della vita fornendo prospettive e competenze diverse, mentre altri sostengono che crei tensioni e conflitti sociali.	Quality of Life	it	10.0
La politica sull'immigrazione è spesso legata a questioni di identità culturale e alcuni vedono l'immigrazione come una minaccia all'identità nazionale e al patrimonio culturale.	Cultural Identity	it	11.0
Altri sostengono che l'identità culturale è in continua evoluzione e che l'immigrazione può arricchire e diversificare l'espressione culturale.	Cultural Identity	it	11.0
La politica sull'immigrazione è spesso determinata dal sentimento pubblico e dagli atteggiamenti nei confronti dell'immigrazione, con alcuni che sostengono restrizioni più severe e altri che sostengono politiche più ampie.	Public Sentiment	it	12.0
Il sentimento pubblico è influenzato da molti fattori, tra cui la copertura mediatica, il discorso politico e l'esperienza personale.	Public Sentiment	it	12.0
La politica sull'immigrazione è spesso influenzata dall'opinione politica, con diversi partiti politici e gruppi di interesse che assumono posizioni diverse a seconda dei loro valori e ideali.	Political	it	13.0
La politica sull'immigrazione può essere una questione politica separata, che i politici usano per mobilitare la loro base e fare appello agli elettori di diversi gruppi demografici.	Political	it	13.0
Le politiche sull'immigrazione possono influenzare il controllo esterno e la reputazione di un paese, in particolare nei settori dei diritti umani e del diritto internazionale.	External Regulation and Reputation	it	14.0
Alcuni sostengono che l'immigrazione minacci l'identità culturale di un paese perché introduce nuovi costumi e credenze. Altri, invece, sostengono che la diversità arricchisce la cultura di una società e dovrebbe essere celebrata.	Cultural Identity	it	11.0
È importante che gli immigrati comprendano e rispettino l'identità culturale dei paesi che visitano, così come preservino e condividano il loro patrimonio culturale unico.	Cultural Identity	it	11.0
La percezione pubblica dell'immigrazione varia a seconda della località e del contesto. In alcune regioni, gli immigrati sono accolti e apprezzati per i servizi che forniscono alla comunità, mentre in altre regioni le persone possono temere o risentirsi per gli immigrati che portano via il loro lavoro o le loro risorse.	Public Sentiment	it	12.0
I media svolgono un ruolo nel plasmare l'atteggiamento pubblico nei confronti degli immigrati, con storie sensazionali sui crimini degli immigrati che promuovono atteggiamenti negativi nei confronti degli immigrati.	Public Sentiment	it	12.0
La politica sull'immigrazione è spesso politicamente motivata, con i politici che cercano di ottenere voti facendo appello ai loro sostenitori o assumendo una posizione dura sull'immigrazione.	Political	it	13.0
Le relazioni internazionali possono anche influenzare la politica di immigrazione di un paese, con considerazioni e accordi diplomatici che influenzano il flusso di migranti.	Political	it	13.0
Organizzazioni e trattati internazionali come le Nazioni Unite e l'Unione Europea svolgono un ruolo nella regolamentazione e nella definizione della politica sull'immigrazione.	External Regulation and Reputation	it	14.0
La reputazione di un paese come luogo accogliente o ostile per gli immigrati ha importanti implicazioni economiche e politiche che influenzano il turismo, il commercio e le relazioni diplomatiche.	External Regulation and Reputation	it	14.0
L'immigrazione può avere effetti economici sia positivi che negativi su un paese, ad esempio fornendo manodopera a basso costo e aumentando la concorrenza per posti di lavoro e risorse.	Economic	it	1.0
La capacità di un paese di accettare e sostenere gli immigrati è limitata dalla sua capacità di alloggi, istruzione, assistenza sanitaria e altre risorse.	Capacity and Resources	it	2.0
Le considerazioni etiche sulla migrazione includono domande sui diritti dei migranti e sulle responsabilità dei paesi ospitanti nei loro confronti.	Morality	it	3.0
La politica dell'immigrazione deve essere equa e giusta, fornendo pari opportunità a tutti gli immigrati.	Fairness and Equality	it	4.0
Le leggi e le politiche sull'immigrazione devono rispettare i principi legali e costituzionali ed è responsabilità del governo farle rispettare.	Legality, Constitutionality, Jurisdiction	it	5.0
Una politica di immigrazione efficace richiede un attento esame e considerazione degli obiettivi, degli impatti e delle strategie di attuazione.	Policy Prescription and Evaluation	it	6.0
L'immigrazione può essere collegata alla criminalità e alle questioni penali, compresa la sicurezza delle frontiere e l'attività criminale legata all'immigrazione.	Crime and Punishment	it	7.0
La politica di immigrazione ha implicazioni per la sicurezza e la difesa nazionale, comprese le potenziali minacce di gruppi terroristici e conflitti geopolitici.	Security and Defense	it	8.0
La salute e la sicurezza dei migranti e delle comunità ospitanti dovrebbero essere considerate nella politica migratoria, comprese questioni come il controllo delle malattie e l'igiene.	Health and Safety	it	9.0
La migrazione incide sulla qualità della vita sia delle comunità migranti che di quelle ospitanti, incidendo sulla coesione sociale, sui servizi pubblici e sull'inclusione culturale.	Quality of Life	it	10.0
L'immigrazione plasma l'identità culturale dei paesi e dei loro popoli, con effetti positivi e negativi sulla diversità e sulla coesione sociale.	Cultural Identity	it	11.0
Gli atteggiamenti pubblici e le percezioni dell'immigrazione hanno importanti conseguenze politiche e sociali.	Public Sentiment	it	12.0
La politica di immigrazione è spesso influenzata da considerazioni politiche come la strategia elettorale e l'ideologia del partito.	Political	it	13.0
Le organizzazioni e i trattati internazionali svolgono un ruolo nel plasmare e regolare la politica sull'immigrazione, che influisce sulla reputazione e sulla posizione globale di un paese.	External Regulation and Reputation	it	14.0
Il matrimonio tra persone dello stesso sesso è una questione morale ed etica e negare a qualcuno il diritto di sposarsi a causa dell'orientamento sessuale è discriminatorio e ingiusto.	Morality	it	3.0
Tutte le persone, indipendentemente dall'orientamento sessuale, dovrebbero avere il diritto di sposarsi con gli stessi diritti e tutele legali delle coppie eterosessuali.	Fairness and Equality	it	4.0
È ingiusto e immorale negare alle persone il diritto di sposarsi a causa dell'orientamento sessuale.	Morality	it	3.0
Tutte le persone, indipendentemente dall'orientamento sessuale, dovrebbero avere il diritto di sposarsi con gli stessi diritti e tutele legali delle coppie eterosessuali.	Fairness and Equality	it	4.0
L'accettazione e gli atteggiamenti nei confronti del matrimonio tra persone dello stesso sesso sono cambiati nel tempo in molte parti del mondo, ma restano da superare significative barriere culturali e sociali.	Public Sentiment	it	12.0
Le politiche e le leggi sul matrimonio tra persone dello stesso sesso hanno un impatto significativo sulla società ed è importante valutarne l'impatto e apportare le modifiche necessarie per garantire equità e uguaglianza.	Policy Prescription and Evaluation	it	6.0
La legalizzazione del matrimonio tra persone dello stesso sesso ha vantaggi economici in quanto aumenta il turismo e crea nuove opportunità di lavoro nel settore dei matrimoni.	Economic	it	1.0
Sebbene il matrimonio tra persone dello stesso sesso possa sfidare le nozioni tradizionali di ruoli di genere e norme sociali, alcuni ritengono che aiuti a promuovere un'identità culturale più diversificata e accettabile.	Cultural Identity	it	11.0
Negare alle coppie dello stesso sesso il diritto di sposarsi influisce negativamente sulla loro salute e sul loro benessere, in quanto subiscono discriminazioni e non hanno accesso a importanti tutele legali ed economiche.	Health and Safety	it	9.0
Il dibattito sul matrimonio tra persone dello stesso sesso è un'importante questione politica in molti paesi in cui partiti politici e politici assumono posizioni diverse a seconda delle loro convinzioni e delle opinioni degli elettori.	Political	it	13.0
La legalizzazione del matrimonio tra persone dello stesso sesso è un passo importante verso l'uguaglianza per la comunità LGBTQ+ e garantisce gli stessi diritti e opportunità delle coppie eterosessuali.	Fairness and Equality	it	4.0
Per molti, il matrimonio tra persone dello stesso sesso è una questione morale, con alcuni che affermano che va contro i valori tradizionali, mentre altri insistono sul fatto che celebra l'amore e la compagnia indipendentemente dal genere.	Morality	it	3.0
Negare alle coppie dello stesso sesso il diritto di sposarsi è una chiara violazione dei diritti umani fondamentali come l'uguaglianza e la non discriminazione.	Fairness and Equality	it	4.0
Il matrimonio tra persone dello stesso sesso offre importanti vantaggi sanitari alle coppie, tra cui: B. Benefici medici, copertura assicurativa e accesso alle cure mediche necessarie in caso di malattia o emergenza.	Health and Safety	it	9.0
Un funzionario a conoscenza del progetto di bilancio ha fornito i dettagli della richiesta di finanziamento prima che il presidente Biden annunciasse il piano lunedì, parlando a condizione di anonimato.	Capacity and Resources	it	2.0
L'ICE continuerà a monitorare le singole strutture di detenzione per garantire che le condizioni siano favorevoli in collaborazione con ERO, OPR e altre agenzie di regolamentazione all'interno del Dipartimento per la sicurezza interna.	Capacity and Resources	it	2.0
HSI ha lavorato con l'FBI per convincere il Dipartimento di Giustizia ad incriminare due complici.	Capacity and Resources	it	2.0
Coordina la gestione della detenzione con i 25 uffici sul campo di ERO per fornire un ambiente sicuro per i non cittadini in custodia dell'ICE attraverso la conformità delle strutture, il monitoraggio sul campo e l'acquisto di strutture di detenzione.	Capacity and Resources	it	2.0
25 L'ERO Field Office facilita il supporto logistico e operativo delle attività di evasione fiscale sviluppando, implementando e monitorando piani e procedure che supportano la missione del Piano d'azione sull'evasione in tutto il paese.	Capacity and Resources	it	2.0
Questi centri utilizzano competenze tecniche, strumenti analitici e competenze delle forze dell'ordine per sviluppare consigli di espulsione basati sull'intelligence per i non cittadini.	Capacity and Resources	it	2.0
Attraverso la raccolta dei dati, l'analisi e il miglioramento della tecnologia e dei processi, LESA fornisce strumenti, ricerche e raccomandazioni per supportare il processo decisionale e la pianificazione dell'ICE.	Capacity and Resources	it	2.0
Lavorando con le parti interessate interagenzia e interagenzia, ambasciate e consolati stranieri e partner internazionali, la divisione sviluppa e implementa strategie di espulsione per cittadini non statunitensi in attesa di espulsione.	Capacity and Resources	it	2.0
Sosteniamo le politiche universali sui diritti umani e la protezione di migranti e rifugiati e chiediamo un'azione multilaterale per affrontare le cause profonde della migrazione, compreso il cambiamento climatico.	Capacity and Resources	it	2.0
Un'organizzazione senza scopo di lucro che soddisfa gli standard di idoneità di PA, stato e programma e dispone dell'autorità amministrativa per amministrare i programmi designati e i fondi del programma per conto del CDSS.	Capacity and Resources	it	2.0
Se ti trovi negli Stati Uniti senza autorizzazione o condizionale da parte di un funzionario dell'immigrazione, la tua presenza illegale inizia dalla data in cui sei entrato nel paese senza autorizzazione o condizionale.	Crime and Punishment	it	7.0
Generalmente, se sei ammesso negli Stati Uniti o trattenuto da un funzionario dell'immigrazione, riceverai un Modulo Iâ94, Record of Arrival/Attempt, con la data esatta in cui intendi partire.	Crime and Punishment	it	7.0
Se lasci gli Stati Uniti dopo l'inizio della procedura di espulsione, inclusa la rimozione volontaria, è tua responsabilità informare l'Ufficio amministrativo per la revisione dell'immigrazione.	Crime and Punishment	it	7.0
La linea dei 10 anni si applica anche se parti prima, durante o dopo l'inizio della rimozione dal DHS.	Crime and Punishment	it	7.0
Pertanto, puoi richiedere nuovamente il permesso di ingresso negli Stati Uniti anche se non sei permanentemente ammesso, ma solo se non sei fisicamente presente negli Stati Uniti da almeno 10 anni dopo la tua ultima partenza.	Crime and Punishment	it	7.0
A seconda delle prestazioni di immigrazione che stai richiedendo, la legge potrebbe squalificarti come inammissibile.	Crime and Punishment	it	7.0
"È necessario scrivere ""ritornato negli Stati Uniti entro i tre o dieci anni previsti dalla legge"" per facilitare l'identificazione ed evitare ritardi nella disposizione della pratica."	Crime and Punishment	it	7.0
L'Immigration and Nationality Act (INA) delinea i motivi dell'inammissibilità di una persona.	Crime and Punishment	it	7.0
Il Texas ha un basso numero di criminali immigrati clandestini perché gli immigrati clandestini passano inosservati per anni.	Crime and Punishment	it	7.0
Gli immigrati, compresi i non cittadini ispanici, sono leggermente più propensi a denunciare il crimine rispetto ai nativi, secondo il National Crime Reporting Survey, che è progettato per misurare la disponibilità delle persone a denunciare il crimine.	Crime and Punishment	it	7.0
L'assimilazione è il processo mediante il quale un gruppo o una cultura di minoranza adotta il comportamento, i valori, i costumi e le credenze del gruppo di maggioranza nel paese ospitante.	Cultural Identity	it	11.0
Il termine assimilazione è spesso usato per descrivere gli immigrati che si trasferiscono in un nuovo posto. Tuttavia, è anche usato per discutere di gruppi etnici.	Cultural Identity	it	11.0
Gli aborigeni, gli immigrati e le minoranze etniche spesso cambiano o nascondono aspetti della loro cultura, tra cui lingua, cibo, abbigliamento e pratiche spirituali, per adottare i valori e i comportamenti sociali della cultura dominante.	Cultural Identity	it	11.0
È importante ricordare che l'integrazione volontaria è spesso una risposta alla pressione di una cultura più dominante e che l'adattamento è la soluzione per mantenere le persone al sicuro e in vita. Assimilazione forzata: questa è una situazione in cui una minoranza o un gruppo etnico è costretto a sottomettersi. La loro identità culturale, lingua, usi e costumi corrispondono a quelli del gruppo dominante.	Cultural Identity	it	11.0
Sebbene questo fosse un processo comune tra gli stati, è diventato una questione politica controversa: alcuni politici e il pubblico hanno sostenuto in passato che gli immigrati europei si sono assimilati più velocemente delle minoranze.	Cultural Identity	it	11.0
Oggi e in passato, molti bianchi in questo paese vedono gli immigrati e le minoranze come una minaccia alla cultura nazionale, temendo le nostre differenze e applicando pressioni dirette e indirette, incluse minacce, a coloro che non sono d'accordo. e violenza.	Cultural Identity	it	11.0
L'assimilazione culturale aveva lo scopo di limitare l'auto-segregazione, ma durante questo periodo gli immigrati furono incoraggiati ad assimilarsi per la stabilità sociale e la prosperità economica.	Cultural Identity	it	11.0
Un altro studio sulle famiglie di immigrati ha rilevato che più fratelli nati all'estero avevano maggiori probabilità di essere disoccupati, finire la scuola in meno anni, guadagnare meno e sposare coniugi nati all'estero.	Cultural Identity	it	11.0
Mentre l'assimilazione forzata è una forma di violenza, costringere le minoranze ad adottare pratiche culturali che non sono le loro è nel migliore e nel peggiore dei casi.	Cultural Identity	it	11.0
Le popolazioni indigene, le minoranze etniche e gli immigrati spesso sperimentano l'assimilazione in modi diversi, quindi è importante discutere e considerare attentamente come si è verificata questa assimilazione e le sue implicazioni.	Cultural Identity	it	11.0
Nel settore dell'ospitalità, il 38% degli imprenditori è nato al di fuori degli Stati Uniti, rispetto al 24% dei proprietari di negozi.	Economic	it	1.0
Con 85 milioni di americani che vivono in contee che hanno perso la loro età lavorativa principale tra il 2011 e il 2021 e 160 milioni che vivono in contee con popolazione in calo o stabile, è tempo di ricominciare a discutere di come l'immigrazione si colleghi allo sviluppo economico locale e regionale. .	Economic	it	1.0
Le 20 contee più popolose degli Stati Uniti rappresentano il 36% degli immigrati con almeno una laurea, rispetto al 19% della popolazione totale della nazione.	Economic	it	1.0
I politici statali e locali, in particolare, devono sviluppare un quadro di riferimento per comprendere meglio perché gli immigrati sono importanti per l'America e il valore che gli immigrati apportano alle loro comunità.	Economic	it	1.0
L'investimento minimo TEA è aumentato a $ 900.000 (da $ 500.000) per tenere conto dell'inflazione.	Economic	it	1.0
Il DHS segue l'allegato [DHS/USCIS/ICE/CBP-001 Alien Document and National Document Tracking System, DHS/USCIS-007 Benefits Information System e DHS/USCIS-018 Immigration Biometrics and Background] e fornisce una valutazione dell'impatto sulla privacy [DHS]. di ]. ] pubblicazione. /USCIS/PIA-016(a) Applied and Computer-Linked Information Systems], disponibile all'indirizzo www.dhs.gov/privacy.	Economic	it	1.0
Anche una differenza salariale del 10% su un viaggio di andata e ritorno di un anno consente a questi lavoratori poco qualificati di trovare lavoro negli Stati Uniti invece di essere rimandati a casa. Un programma contro la povertà efficace, ben pianificato e ben implementato può aumentare il reddito fino a 35 volte quello con cui è iniziato.	Economic	it	1.0
Ma l'attuale divario salariale e le innegabili richieste di manodopera tra paesi ricchi e paesi poveri fanno sì che tutti i movimenti umani avvengano senza diritti legali e senza il sostegno dei datori di lavoro.	Economic	it	1.0
L'impatto dell'immigrazione sui salari è negativo per le occupazioni con lavoratori domestici meno istruiti e tassi più elevati di immigrati. 4 L'immigrazione colpisce l'occupazione così come i salari. Opportunità per i lavoratori locali.	Economic	it	1.0
L'afflusso di immigrati ha aumentato la concorrenza per il lavoro, con conseguenti minori opportunità di lavoro per i lavoratori domestici. Tuttavia, l'immigrazione ha avuto scarso impatto sulle opportunità di lavoro. 6 L'effetto netto dell'immigrazione sull'economia statunitense è positivo. 7 Gli immigrati aumentano il numero di lavoratori nell'economia, determinando una maggiore crescita economica e salari più elevati per i lavoratori domestici.	Economic	it	1.0
Le nuove regole danno ai richiedenti asilo più potere di ascoltare e pronunciarsi sui richiedenti asilo (casi solitamente assegnati ai giudici dell'immigrazione) quando si presentano al confine meridionale degli Stati Uniti.	External Regulation and Reputation	it	14.0
L'indicatore di gestione della migrazione (MGI) fornisce un quadro per valutare l'integrità delle politiche migratorie nazionali e per identificare le lacune e le priorità per lo sviluppo delle capacità istituzionali e i programmi di migrazione.	External Regulation and Reputation	it	14.0
Vengono prese in considerazione varie sottodimensioni di ciascuna categoria di polizze, tra cui ammissibilità, condizioni, garanzie di status e diritti associati.	External Regulation and Reputation	it	14.0
Il cruscotto è organizzato attorno a cinque dimensioni politiche: coesione istituzionale, riduzione dei costi della migrazione, protezione dei diritti dei migranti e delle famiglie, promozione dell'integrazione e del reinserimento e aumento dell'impatto della migrazione sullo sviluppo.	External Regulation and Reputation	it	14.0
Le norme sull'immigrazione sono contenute nel titolo 8 del Code of Federal Regulations (stranieri e cittadini), che equivale al titolo 8 del codice degli Stati Uniti (stranieri e nazionalità).	External Regulation and Reputation	it	14.0
Le esigenze e le sfide della promozione dell'uguaglianza di genere e della giustizia sono evidenti in tutto il mondo.	Fairness and Equality	it	4.0
Ha costruito una leadership e capacità eccezionali ai più alti livelli politici, tra cui il governo degli Stati Uniti, la Casa Bianca, il Dipartimento di Stato e la Missione degli Stati Uniti presso le Nazioni Unite, l'Agenzia per lo sviluppo internazionale (USAID) e il Dipartimento di Salute. . Risorse umane. e servizi umani (HHS).	Fairness and Equality	it	4.0
Mentre l'amministrazione Trump continua ad attaccare le questioni di genere, in particolare la salute sessuale e riproduttiva e i diritti LGBTQI+, l'amministrazione Biden deve affrontare un imperativo strategico per promuovere l'uguaglianza di genere e l'equità necessarie per raggiungere gli obiettivi di salute e sviluppo globali degli Stati Uniti. Mostra che la prosperità economica e la sicurezza nazionale possono essere raggiunte.	Fairness and Equality	it	4.0
Mentre altre amministrazioni hanno uffici dedicati alle donne e alle ragazze, l'attuale Consiglio per la politica di genere della Casa Bianca è il primo consiglio politico della presidenza a concentrarsi sull'equità di genere e sull'uguaglianza di genere, comprese le donne e le ragazze, ma è più inclusivo e ampio. . Agenda di genere comprese le questioni LGBTQI+.	Fairness and Equality	it	4.0
La Casa Bianca avrà probabilmente la responsabilità di organizzare e coordinare i processi tra agenzie che devono gestire le tensioni e la concorrenza tra agenzie e istituzioni e richiedono un supporto continuo di alto livello e personale da parte dell'amministrazione.	Fairness and Equality	it	4.0
Secondo la Camera di commercio degli Stati Uniti, Diversità, equità e inclusione (spesso chiamata DEI) è un quadro di sviluppo sociale che può essere applicato a contesti aziendali.	Fairness and Equality	it	4.0
La pandemia ha esacerbato le sfide sanitarie ed economiche che i migranti devono affrontare e affrontare i bisogni dei migranti è diventato sempre più importante con l'aumento dell'attività dei migranti lungo il confine tra Stati Uniti e Messico.	Health and Safety	it	9.0
Sebbene molti cittadini non anziani vivano in famiglie con lavoratori a tempo pieno, hanno meno accesso alle assicurazioni private perché è più probabile che lavorino in posti di lavoro a bassa e bassa retribuzione e in settori in cui i datori di lavoro hanno meno probabilità di offrire pensioni. - Rapporto di sponsorizzazione.	Health and Safety	it	9.0
B. Alcuni immigrati, come i titolari di uno status protetto temporaneo, sono legali ma non idonei e non idonei per Medicaid o CHIP, a seconda di quanto tempo sono stati nel paese.	Health and Safety	it	9.0
Gli individui con stato DACA non sono considerati legalmente disponibili per l'idoneità all'assicurazione sanitaria e non sono idonei per le opzioni di copertura ai sensi dei regolamenti emanati dai Centers for Medicare and Medicaid Services (CMS).	Health and Safety	it	9.0
Anche se si qualificano per la copertura, molte famiglie immigrate rimangono non assicurate a causa delle numerose barriere che devono affrontare al momento dell'iscrizione, tra cui paura, confusione sul processo di ammissibilità, difficoltà con il processo di iscrizione e problemi di lingua e alfabetizzazione.	Health and Safety	it	9.0
La ricerca mostra che i cambiamenti della politica sull'immigrazione dell'amministrazione Trump stanno rendendo le famiglie immigrate ansiose di iscrivere se stesse e/o i loro figli a Medicaid e CHIP nonostante siano ammissibili.	Health and Safety	it	9.0
"Jennifer Chacon, ""Gli Stati hanno approvato leggi progettate per impedire a tutti i gruppi di attraversare i confini statali, compresi quelli con precedenti penali, beneficiari di sovvenzioni pubbliche, schiavi e neri liberi""."	Legality, Constitutionality, Jurisdiction	it	5.0
"""Amanda Frost è un'entusiasmante aggiunta alla nostra facoltà con la sua competenza ed esperienza in materia di immigrazione e diritto costituzionale"", ha affermato Dean Risa Goluboff."	Legality, Constitutionality, Jurisdiction	it	5.0
"""L'idea di questo libro mi è venuta quando ho guardato le storie di persone che hanno perso la cittadinanza nel corso della storia americana e mi sono reso conto che si trattava di un fenomeno molto più ampio di quanto avessi pensato in precedenza"", ha detto Frost."	Legality, Constitutionality, Jurisdiction	it	5.0
"Vedendo il sistema di giustizia penale al lavoro, voleva ""farne parte e rappresentare le persone che non vogliono che la loro voce sia ascoltata"". Dopo il college, ha lavorato per un anno come paralegale in diritto dei diritti civili. Ha fatto domanda per studiare legge presso l'istituto e la scuola da cui si è laureato."	Legality, Constitutionality, Jurisdiction	it	5.0
"""Trovo le questioni [dell'immigrazione] interessanti su tutti i fronti, dalle questioni politiche alle interpretazioni legali e alle complesse questioni costituzionali sul rapporto tra i tre rami del governo"", ha affermato."	Legality, Constitutionality, Jurisdiction	it	5.0
Le autorità statali sono autorizzate a far rispettare le leggi federali sull'immigrazione arrestando gli immigrati precedentemente condannati per reati.	Legality, Constitutionality, Jurisdiction	it	5.0
"Guardi l'ufficiale e dici: ""Non puoi guardarmi e dirmi che sto bene?"" Potresti pensare. Sfortunatamente, non è vero. Abbastanza"	Morality	it	3.0
Pertanto, se fumi marijuana medica o marijuana ricreativa, potresti essere considerato moralmente depravato, anche se è legale nel tuo stato e non sei mai stato arrestato o condannato per una sostanza controllata.	Morality	it	3.0
Carattere morale e residente permanente legale (LPR). Se sei un residente permanente legale (LPR) e desideri richiedere la cittadinanza/cittadinanza statunitense, devi dimostrare un carattere morale accettabile ai funzionari dell'USCIS durante la tua residenza permanente legale.	Morality	it	3.0
Carattere etico e procedura nei tribunali dell'immigrazione. Quando una persona è soggetta a deportazione o rimozione da parte dell'USCIS, deve dimostrare un buon carattere morale.	Morality	it	3.0
In un tipico esempio, quando qualcuno richiede la cittadinanza statunitense a causa di gravi lesioni o abusi emotivi, la prova di un successo significativo durante il suo soggiorno negli Stati Uniti può minare l'intero caso di quella persona.	Morality	it	3.0
Se non fanno domanda nel primo anno, perdono la possibilità di ottenere asilo.	Other	it	15.0
Più di 200.000 afgani, ucraini, venezuelani, nicaraguensi, cubani e haitiani sono passati attraverso il più formale processo di libertà vigilata umanitaria.	Other	it	15.0
I funzionari della Casa Bianca e della Sicurezza Nazionale hanno iniziato a discutere della crisi dell'immigrazione e di ulteriori restrizioni per limitare l'ingresso dei migranti negli Stati Uniti tra il confine tra Stati Uniti e Messico.	Other	it	15.0
"""Come questione gestionale, consideriamo tutte le considerazioni legali prima di procedere con una politica, e le nuove normative proposte riflettono queste considerazioni"", ha dichiarato un funzionario del governo in una nota."	Other	it	15.0
Una proposta per riformare il sistema di immigrazione è in fase di stallo poiché le autorità temono un numero record di migranti in arrivo al confine meridionale degli Stati Uniti, hanno riferito fonti alla CNN.	Other	it	15.0
"""Non è la nostra massima priorità, non è la nostra seconda priorità"", ha detto in precedenza un funzionario dell'amministrazione ai giornalisti, sottolineando gli sforzi per aprire l'accesso legale all'uso delle app negli Stati Uniti e sottolineando che il voto sulla riforma si basa sul disegno di legge. con il Congresso. ."	Other	it	15.0
Come parte della visita medica per l'immigrazione, il richiedente, il chirurgo civile e tutti gli altri operatori sanitari che valutano il richiedente devono firmare il modulo e certificare che ciò che dicono è vero.	Policy Prescription and Evaluation	it	6.0
Se il rifugiato necessita solo del test vaccinale, le parti del modulo che devono essere compilate sono le informazioni sulla domanda, il test vaccinale e il certificato.	Policy Prescription and Evaluation	it	6.0
USCIS accetta un richiedente affetto da una specifica disabilità fisica o dello sviluppo o disabilità intellettiva quando un altro richiedente affetto dalla stessa disabilità o disturbo può beneficiare di una rinuncia alla disabilità.	Policy Prescription and Evaluation	it	6.0
È possibile ottenere una rinuncia per disabilità solo completando il modulo N-648, che richiede la prova che la disabilità fisica o mentale o la disabilità intellettiva del richiedente impediscono al richiedente di soddisfare i requisiti di lingua inglese o cittadinanza, o entrambi. Sistemazione ragionevole.	Policy Prescription and Evaluation	it	6.0
I traduttori che forniscono servizi di traduzione per gli esami medici di telemedicina non sono tenuti a compilare il modulo N-648, certificazione dell'interprete.	Policy Prescription and Evaluation	it	6.0
Per anni, il Congresso non è riuscito a concordare una riforma globale dell'immigrazione, spostando di fatto alcune decisioni politiche chiave ai rami esecutivo e giudiziario e alimentando il dibattito nelle camere del governo statale e locale.	Political	it	13.0
Le mosse di Biden per invertire le politiche dell'era Trump includono l'allentamento delle restrizioni sull'immigrazione negli Stati Uniti, la fine del divieto di viaggio, la revoca di una moratoria sull'elaborazione della carta verde e l'arresto della costruzione di un muro lungo il confine tra Stati Uniti e Messico.	Political	it	13.0
Nel frattempo, uno storico afflusso di migranti al confine meridionale minaccia di minare ulteriormente gli sforzi di Biden: nel maggio 2022, gli arresti al confine hanno raggiunto quasi 240.000, un massimo di 20 anni dopo il calo dovuto alla pandemia.	Political	it	13.0
Al vertice delle Americhe del 2022, 23 leader dell'emisfero occidentale hanno concordato un accordo sulla migrazione volto ad aumentare gli aiuti per le popolazioni di rifugiati, migliorare la gestione delle frontiere e coordinare meglio le risposte alle emergenze.	Political	it	13.0
Anche Biden e il presidente messicano Andrés Manuel López Obrador hanno visitato il Sud America. Si propone un piano comune per le infrastrutture di sicurezza delle frontiere per estendere i visti di lavoro temporanei e aumentare gli investimenti nella sorveglianza delle frontiere.	Political	it	13.0
"""Prima degli anni '20, la tendenza generale del dibattito sull'immigrazione era negativa, ma nel giro di una generazione - dal 1945 al 1965 - divenne molto positiva"", ha detto il professore di economia e storico economico Ron Abramitzky. La Stanford University collabora con ricercatori di intelligenza artificiale per pubblicare un nuovo lavoro."	Public Sentiment	it	12.0
Oltre a Card e Abramitzky, il team include l'informatica Serena Chang di Stanford. Chris Baker, economista a Stanford. Julia Mendelsohn è data scientist presso l'Università del Michigan. Dan Jurafsky è professore di linguistica e informatica a Stanford. ; Professore; Rob Voigt, professore assistente di linguistica, Northwestern University.	Public Sentiment	it	12.0
Per costruire un modello di apprendimento automatico in grado di identificare con precisione le voci degli immigrati, il team ha valutato manualmente campioni di parlato di ricercatori umani per determinare se erano positivi, negativi o neutri e come rappresentavano gli immigrati.	Public Sentiment	it	12.0
Il tono pro-immigrati nel recente discorso politico riflette atteggiamenti sempre più positivi in ​​tutto il paese.	Public Sentiment	it	12.0
Come riportato il mese scorso, l'immigrazione clandestina è il secondo problema pubblico più alto per l'inclusione razziale tra i 14 problemi valutati quest'anno.	Public Sentiment	it	12.0
"""Non abbiamo bisogno di fare pressioni sul presidente Biden sul divieto di asilo, stiamo mobilitando le persone per alzare la voce contro questa terribile ingiustizia"", ​​ha affermato Bilal Asyar, direttore ad interim della campagna della #WelcomeWithDignity Coalition. Diritto dell'immigrazione e istituzioni legali."	Public Sentiment	it	12.0
L'Organizzazione Mondiale della Sanità definisce la qualità della vita come una valutazione soggettiva della propria percezione della realtà riguardo ai propri obiettivi, vista attraverso la lente della propria cultura e del proprio sistema di valori.	Quality of Life	it	10.0
Costerà al nostro sistema di asilo milioni di dollari in costi amministrativi e supporto legale per coloro che abusano del sistema con reclami infondati, falsi o dolosi - vedi il nostro briefing sull'onere e sui costi crescenti dell'abuso del sistema di asilo.	Quality of Life	it	10.0
"La congestione sta peggiorando: Londra è ora la città più congestionata del mondo, con la crescente congestione che ha portato alla frenetica decisione del governo di passare alle ""autostrade intelligenti"", ha scoperto la società di dati sul traffico Enrix. Riduci la sicurezza di guida e metti a rischio le famiglie, elimina la spalla dura."	Quality of Life	it	10.0
Per non parlare dell'incubo per la pubblica sicurezza creato dall'impossibilità di rintracciare migliaia di immigrati clandestini che entrano nel Paese in barca, aereo e camion, e dalla tendenza a distruggere deliberatamente le carte d'identità di chi entra nel Paese. .	Quality of Life	it	10.0
Le leggi che discriminano i non cittadini e i programmi e le politiche che non riescono ad affrontare i loro bisogni speciali e le loro vulnerabilità spesso impediscono alle famiglie e alle loro famiglie di accedere ai servizi necessari.	Quality of Life	it	10.0
La capacità di una donna di migrare può essere limitata da fattori personali e familiari come l'età, l'anzianità familiare, la razza/etnia, lo stato civile e la presenza o l'assenza di figli.	Quality of Life	it	10.0
Gli immigrati sono disumanizzati, condannati, detenuti arbitrariamente e talvolta separati dai loro figli a causa delle loro convinzioni etniche.	Quality of Life	it	10.0
Barriere e muri nascono dalla convinzione che il blocco di percorsi di movimento sicuri e ordinati e il loro deliberato rafforzamento renderanno le persone meno disposte a lasciare le loro terre.	Quality of Life	it	10.0
Gli immigrati devono dimostrare di temere persecuzioni al loro ritorno.	Quality of Life	it	10.0
Il numero è stato determinato intervistando persone in tutto il paese su una serie di argomenti tra cui l'accessibilità economica degli alloggi, il costo della vita, il tempo di viaggio, l'inquinamento, la criminalità, la salute, l'accessibilità economica, l'intrattenimento e l'occupazione.	Quality of Life	it	10.0
Dall'11 settembre, il Department of Homeland Security (DHS) e il governo federale, insieme ai suoi numerosi partner nei settori pubblico e privato e nelle comunità nazionali e globali, hanno lavorato per ripristinare e migliorare drasticamente ciò che è nuovo. Patria. La sicurezza è sicurezza fisica. Le minacce dinamiche migliorano la capacità di mitigare, rispondere e recuperare da tutti i tipi di attacchi e disastri.	Security and Defense	it	8.0
US Citizenship and Immigration Services (USCIS) ha aggiornato i suoi permessi di lavoro per includere un campo leggibile dalla macchina che consente agli ufficiali di controllo delle frontiere di identificare in modo più efficace le persone autorizzate a immigrare e precedentemente controllate dagli ufficiali dell'USCIS.	Security and Defense	it	8.0
NOI. La Guardia Costiera migliora la capacità della Marina di rispondere alle minacce creando una forza americana significativa, comprese le forze di combattimento, l'antiterrorismo e la presenza e il dispiegamento di armi di distruzione di massa. Capacità di rispondere rapidamente alle squadre di sicurezza marittima e portuale. Minacce interne alla navigazione e risposte successive.	Security and Defense	it	8.0
Rilevamento delle radiazioni: il CBP ha implementato schermi antiradiazioni e altre tecnologie di rilevamento delle radiazioni nei porti, alle frontiere terrestri e nelle strutture postali di tutto il mondo.	Security and Defense	it	8.0
Dall'11 settembre, il Department of Homeland Security (DHS) e il governo federale, insieme ai suoi numerosi partner nei settori pubblico e privato e nelle comunità nazionali e globali, hanno lavorato per ripristinare e migliorare drasticamente ciò che è nuovo. Patria. La sicurezza è sicurezza fisica. Le minacce dinamiche migliorano la capacità di mitigare, rispondere e recuperare da tutti i tipi di attacchi e disastri.	Security and Defense	it	8.0
"I lettori moderni possono apprezzare i matrimoni ""uomo e donna"" organizzati dai club maschili e femminili all'inizio del XX secolo per raccogliere fondi per Liberty Bonds."	Capacity and Resources	it	2.0
Esplora gli aspetti culturali dell'omosessualità come Gesù, il suo matrimonio immaginario e la storia di Mark Twain - come ha sposato Kate Wilson, il cui lavoro Nancy Jackson non ha osato pubblicare.	Capacity and Resources	it	2.0
"Dopo un'udienza privata: il giudice del caso di omicidio di Chicago del 1923 stabilì che ""il fatto che Thompson fosse un uomo non influiva sul suo status di marito, che era una questione di interpretazione della legge"". A Thompson non è stato permesso di testimoniare. , perché allora una donna può testimoniare per suo marito""."	Capacity and Resources	it	2.0
Le coppie dello stesso sesso - come le coppie legate, le coppie miste, le coppie conviventi e la poligamia - possono o meno essere legali agli occhi dello stato, ma esistono.	Capacity and Resources	it	2.0
Come chiede Cliffs, “Dovrebbero essere intesi come gay o ancora inquadrati in una storia trans definita dalla storia gay e lesbica?	Capacity and Resources	it	2.0
Le persone LGBTQ+ che sono già sposate affermano che il divieto consente ancora loro di sposarsi	Crime and Punishment	it	7.0
Le persone LGBTQ+ che desiderano sposarsi nei 32 stati che non hanno pari diritti matrimoniali devono sposarsi oltre i confini statali e far riconoscere al loro stato la loro unione.	Crime and Punishment	it	7.0
Cosa significa il disegno di legge per coloro che si sposano negli stati che vietano il matrimonio LGBTQ+?	Crime and Punishment	it	7.0
Se la Corte Suprema abbatte l'uguaglianza del matrimonio, c'è un modo per ripristinare l'uguaglianza del matrimonio a livello nazionale?	Crime and Punishment	it	7.0
"Clarence Thomas, uno dei giudici di maggioranza che ha ribaltato Roe, ha scritto un'opinione sostenendo che la Corte dovrebbe ""rivisitare"" Obergefell, definendola una delle decisioni errate della Corte. Row rimane sul posto per un tempo molto breve prima di passare."	Crime and Punishment	it	7.0
Le coppie dello stesso sesso hanno vinto la battaglia per l'uguaglianza matrimoniale e godono di molti, se non di tutti, i benefici coniugali previsti dalla legge federale e statale.	Economic	it	1.0
In alcuni stati e nel Distretto di Columbia, le coppie sposate possono detenere la proprietà di beni come le loro case e conti bancari, limitando il modo in cui i prestatori possono allegare determinati beni titolati.	Economic	it	1.0
Per i conviventi non sposati che percepiscono la stessa prestazione ai dipendenti (se il datore di lavoro beneficia anche il convivente), il valore della prestazione del convivente è generalmente pari al reddito imponibile del dipendente sulle imposte federali sul reddito.	Economic	it	1.0
Ora che il matrimonio tra persone dello stesso sesso è riconosciuto, le coppie dello stesso sesso possono godere del conforto di sapere di essere legalmente dalla loro parte quando si tratta di prendere decisioni sui coniugi malati e controllare i beni del coniuge. Morte per mancanza di altri accordi.	Economic	it	1.0
L'impatto economico del matrimonio tra persone dello stesso sesso è positivo per le economie statali e locali, nonché per l'industria dei matrimoni.	Economic	it	1.0
Le organizzazioni internazionali, comprese le Nazioni Unite, hanno approvato risoluzioni a sostegno dei diritti LGBTQ+, ma i gruppi per i diritti affermano che i loro poteri di applicazione sono limitati.	External Regulation and Reputation	it	14.0
"""Nessun diplomatico sano di mente vorrebbe visitare un paese che non è pronto per il matrimonio tra persone dello stesso sesso"", ha detto Dorf."	External Regulation and Reputation	it	14.0
Mentre cresce il sostegno pubblico al matrimonio tra persone dello stesso sesso, continua il dibattito tra individui e organizzazioni che sostengono l'uguaglianza legale e coloro che si oppongono all'uguaglianza del matrimonio basata sulla religione.	External Regulation and Reputation	it	14.0
Alla fine del XX secolo, la liberalizzazione degli atteggiamenti verso l'omosessualità e le leggi che regolano il comportamento omosessuale, in particolare nell'Europa occidentale e negli Stati Uniti, hanno portato a un maggiore interesse accademico e pubblico per l'argomento.	Cultural Identity	it	11.0
All'inizio degli anni 2000, molti paesi e giurisdizioni locali hanno legalizzato il matrimonio tra persone dello stesso sesso. In altre giurisdizioni sono state adottate misure costituzionali per vietare i matrimoni tra persone dello stesso sesso o sono state approvate leggi che negano il riconoscimento di tali matrimoni celebrati altrove.	Cultural Identity	it	11.0
Il fatto che gruppi diversi analizzino lo stesso comportamento in modi diversi dimostra la sua importanza come problema sociale all'inizio del ventunesimo secolo. Mostra anche che esiste diversità culturale all'interno e tra i paesi.	Cultural Identity	it	11.0
La forma più comune di documentazione è il matrimonio di diritto comune. Matrimoni Morgan in cui titolo e proprietà non passano ai figli. Matrimonio di scambio, in cui un fratello di una famiglia sposa un altro fratello. e matrimonio basato sulla poligamia (coniugale) o matrimonio di clan. poligamia (moglie).	Cultural Identity	it	11.0
Aspettative religiose e secolari di matrimonio e sesso\nNel corso del tempo, la storia e la cultura tradizionale scritte da Bachofen e Morgan, tra gli altri, sono state gradualmente vittime dell'omogeneizzazione imposta dal colonialismo.	Cultural Identity	it	11.0
Le organizzazioni internazionali, comprese le Nazioni Unite, hanno approvato risoluzioni a sostegno dei diritti LGBTQ+, ma i gruppi per i diritti affermano che i loro poteri di applicazione sono limitati.	Fairness and Equality	it	4.0
Nel frattempo, nella repubblica semi-autonoma russa della Cecenia, dozzine di uomini sospettati di essere gay sono stati arrestati, torturati e uccisi dal 2017 in due distinte operazioni governative.	Fairness and Equality	it	4.0
I legislatori in Thailandia e Vietnam stanno valutando progetti di legge che legalizzerebbero il matrimonio o la convivenza tra persone dello stesso sesso.	Fairness and Equality	it	4.0
Anche il sostegno alla legalizzazione del matrimonio tra persone dello stesso sesso è più basso nei Caraibi, al 16% in Giamaica e al 23% nella Repubblica Dominicana, secondo ILGA.	Fairness and Equality	it	4.0
Anche i rapporti legali di coniugi, genitori e figli tendevano a sovrapporsi nei gruppi in cui il matrimonio tra persone dello stesso sesso era altamente problematico.	Health and Safety	it	9.0
Contrariamente al modello liberale del matrimonio, i sostenitori del matrimonio legale tra persone dello stesso sesso spesso credono che le unioni impegnate che includono l'intimità sessuale siano preziose perché uniscono le persone in modi unici e unici.	Health and Safety	it	9.0
Alcuni altri paesi hanno costituzioni islamiche che vengono spesso interpretate per vietare alle coppie dello stesso sesso di sposarsi.	Legality, Constitutionality, Jurisdiction	it	5.0
Negli Stati Uniti, il matrimonio tra persone dello stesso sesso è diventato una richiesta ufficiale del movimento per i diritti dei gay dopo la seconda marcia nazionale per i diritti dei gay a Washington nel 1987.	Legality, Constitutionality, Jurisdiction	it	5.0
In altri paesi, le costituzioni adottate contengono un linguaggio secondo cui il matrimonio è tra un uomo e una donna, mentre non esiste un linguaggio che proibisca il matrimonio tra persone dello stesso sesso, specialmente nelle costituzioni più antiche.	Legality, Constitutionality, Jurisdiction	it	5.0
Hanno anche affermato che è inaccettabile e discriminatorio sostituire il matrimonio tra persone dello stesso sesso con leggi separate come la convivenza.	Legality, Constitutionality, Jurisdiction	it	5.0
Nonostante siano relativamente separate, alcune organizzazioni riconoscono pienamente le unioni tra persone dello stesso sesso.	Legality, Constitutionality, Jurisdiction	it	5.0
Sebbene il matrimonio tra persone dello stesso sesso sia regolato dalla legge, dalla religione e dalla tradizione nella maggior parte dei paesi del mondo, le reazioni legali e sociali variano dalla celebrazione da un lato alla criminalizzazione dall'altro.	Morality	it	3.0
Tra la fine del XX e l'inizio del XXI secolo, le opinioni di una o più religioni del mondo (buddismo, induismo, giudaismo, islam e cristianesimo) e le rispettive pratiche di diritto civile venivano spesso citate nei dibattiti nazionali riguardanti il ​​matrimonio tra persone dello stesso sesso.	Morality	it	3.0
Anche in Iran, dove forti convinzioni religiose musulmane criminalizzano l'omosessualità, e persino in Danimarca, dove l'esito di una conferenza di vescovi evangelici luterani (rappresentanti della religione di Stato) apre la strada al primo livello di riconoscimento nazionale. Rapporti omosessuali attraverso unioni registrate.	Morality	it	3.0
In altri casi, il principio di uguaglianza culturale promosso dalla religione dominante non si è trasferito nella sfera politica, anche se ha suscitato un dibattito emotivo tra i cittadini: ad esempio, in Belgio e in Spagna, entra in gioco la legalità dell'omosessualità matrimonio? Organizzazione religiosa, Chiesa cattolica romana.	Morality	it	3.0
Ma la Corte Suprema Roe v. La decisione Wade ha sollevato nuove preoccupazioni sul fatto che la più alta corte della nazione riconsidererà altri diritti legati all'uguaglianza del matrimonio. .	Other	it	15.0
"Le parole ""nessun piano per i prossimi anni"" hanno rappresentato uno sviluppo personale sorprendente per il residente di lunga data a Washington, data la tenacia di Biden quando un senatore ha votato per impedire al governo federale di riconoscere il matrimonio tra persone dello stesso sesso, su cui in precedenza aveva solo insistito. La condizione di uomini e donne all'interno."	Other	it	15.0
C'è ancora violenza e odio. Libri con temi e personaggi LGBTQ sui diritti trans, atleti trans, assistenza sanitaria che afferma il genere e scuole per giovani trans.	Policy Prescription and Evaluation	it	6.0
I politici opportunisti di destra guadagnano potere instillando una paura infondata nelle comunità emarginate che fraintendono questi problemi e poi si proteggono dai loro obiettivi.	Policy Prescription and Evaluation	it	6.0
"Sasha Eisenberg, autrice di Engagement: America's Quarter Same, ha dichiarato: ""In qualità di candidato presidenziale e vicepresidente del Senato, è sempre stato diffidente nei confronti delle questioni LGBT e aveva paura di prendere qualsiasi posizione che i suoi avversari potessero usare per dipingerlo come un uomo di sinistra"". -Il matrimonio sessuale nella guerra dei cent'anni, ha riferito la CNN."	Policy Prescription and Evaluation	it	6.0
Judith Carson-Windsor, moglie dell'attivista per i diritti dei gay Eddie Windsor. Matthew Haynes, co-proprietario del Club Q, un club LGBTQ a Colorado Springs, è stato ucciso in una sparatoria di massa il mese scorso. 5? James Sloah, sopravvissuto allo Shooting Club Q e Michael Anderson; Diversi querelanti nel caso storico sui diritti civili Obergefell v. Hodges, che ha stabilito nel 2015 che le coppie dello stesso sesso possono sposarsi a livello nazionale.	Policy Prescription and Evaluation	it	6.0
Giovedì la Camera dei rappresentanti ha approvato una legislazione che protegge il matrimonio tra persone dello stesso sesso e interrazziale. Questo è l'ultimo passo prima che il disegno di legge vada al presidente Joe Biden per la sua firma e diventi legge.	Policy Prescription and Evaluation	it	6.0
Martedì il presidente Joe Biden ha firmato nuove storiche protezioni federali per le coppie dello stesso sesso e miste, limitando gli sviluppi personali e nazionali su una questione che è diventata più accettata nell'ultimo decennio.	Political	it	13.0
Biden ha firmato l'Affordable Care Act di fronte a migliaia di ospiti nel South Lawn, che secondo la Casa Bianca riflette il significato del momento.	Political	it	13.0
Mentre l'opinione pubblica sul matrimonio tra persone dello stesso sesso ha oscillato nel corso degli anni, sembra improbabile che un simile disegno di legge venga approvato a Washington: secondo un sondaggio senza scopo di lucro, il 68% degli americani sostiene il matrimonio tra persone dello stesso sesso nel 2021, rispetto al 2014. Erano 14 La percentuale di religione pubblica è aumentata lo scorso anno.	Political	it	13.0
"Le parole ""nessun piano per i prossimi anni"" hanno rappresentato uno sviluppo personale sorprendente per il residente di lunga data a Washington, data la tenacia di Biden quando un senatore ha votato per impedire al governo federale di riconoscere il matrimonio tra persone dello stesso sesso, su cui in precedenza aveva solo insistito. La condizione di uomini e donne all'interno."	Political	it	13.0
"""Vedi, ieri c'è stato un ottimo sostegno bipartisan alla Camera e spero che tu lo veda al Senato"", ha detto."	Political	it	13.0
Circa la metà (51%) di coloro che hanno meno di un'istruzione superiore afferma che il matrimonio tra persone dello stesso sesso è molto buono (26%) o abbastanza buono (25%) per la società, mentre il 45% (20%) afferma di non esserlo. Molto male (24%).	Public Sentiment	it	12.0
Sebbene le differenze di parte siano nette indipendentemente dall'età e dal livello di istruzione degli americani, queste differenze sono più modeste tra i giovani adulti che tra gli adulti più anziani.	Public Sentiment	it	12.0
I repubblicani più giovani hanno espresso opinioni più positive sul matrimonio tra persone dello stesso sesso rispetto ai repubblicani più anziani, mentre il divario di età era più ridotto tra i democratici.	Public Sentiment	it	12.0
Il divario di istruzione è leggermente più ampio per i democratici che per i repubblicani.	Public Sentiment	it	12.0
Anche democratici di alto profilo come l'ex presidente Barack Obama erano riluttanti a condividere il loro sostegno al matrimonio tra persone dello stesso sesso: Obama alla fine è diventato il primo presidente a farlo.	Public Sentiment	it	12.0
Sebbene il sostegno al matrimonio tra persone dello stesso sesso sia cresciuto tra le generazioni negli ultimi 15 anni, il divario di età rimane ampio.	Quality of Life	it	10.0
Ad esempio, il 45% degli adulti della generazione silenziosa (nati tra il 1928 e il 1945) consente il matrimonio tra persone dello stesso sesso, mentre il 74% dei millennial (nati tra il 1981 e il 1996) consente il matrimonio tra persone dello stesso sesso.	Quality of Life	it	10.0
Un sondaggio Gallup del 2017 ha rilevato che un americano LGBT su 10 (10,2%) ha sposato un partner dello stesso sesso nei mesi precedenti la decisione dell'alta corte (7,9%).	Quality of Life	it	10.0
Un nuovo sondaggio condotto prima delle elezioni di metà mandato di ottobre ha rilevato che la Corte Suprema nella causa Roe v. Dopo che Wade ha ribaltato la sua decisione, ha sollevato alcune domande sul fatto che il matrimonio tra persone dello stesso sesso sia legale in tutto il paese. Le leggi sull'aborto stanno tornando negli Stati.	Quality of Life	it	10.0
Il Pew Research Center ha interrogato il pubblico sullo status legale del matrimonio tra persone dello stesso sesso.	Quality of Life	it	10.0
Richiede agli stati di mantenere la validità delle licenze di matrimonio al di fuori dello stato, anche per le unioni tra persone dello stesso sesso e multirazziali.	Security and Defense	it	8.0
"""La ricerca della felicità è poter amare chi vuoi"", ha detto."	Security and Defense	it	8.0
Chiarisce che le istituzioni religiose non impongono il matrimonio tra persone dello stesso sesso e che i governi non possono costringerle a proteggere la poligamia.	Security and Defense	it	8.0
Martedì la Camera dei Rappresentanti ha approvato una legislazione per legalizzare il matrimonio tra persone dello stesso sesso a livello nazionale e rafforzare altre protezioni per l'uguaglianza matrimoniale, una risposta diretta a una recente sentenza della Corte Suprema che ha da tempo privato gli stati del diritto all'aborto.	Security and Defense	it	8.0
Da un lato, lo scopo del matrimonio è garantire che la riproduzione e l'educazione dei figli procedano senza intoppi.	Quality of Life	it	10.0
