sentence	label_name	Language	label_ID
Ndoa za watu wa jinsia moja zina athari chanya za kiuchumi, kama vile kuongezeka kwa mapato kutoka kwa watalii na leseni za ndoa, na gharama zinazohusiana na ndoa.	Economic	sw	1.0
Wapinzani wa ndoa za watu wa jinsia moja wanahoji kuwa itasababisha matokeo mabaya ya kiuchumi, kama vile kudhoofisha miundo ya familia ya kitamaduni na kusababisha ukosefu wa utulivu wa kijamii.	Economic	sw	1.0
Kuhalalisha ndoa za jinsia moja kutasaidia wapenzi wa jinsia moja kupata rasilimali na manufaa sawa na wapenzi wa jinsia moja, kwa mfano b. Haki za afya na haki za urithi	Capacity and Resources	sw	2.0
Baadhi ya wanaopinga ndoa za jinsia moja wanahoji kuwa jambo hilo litadhoofisha uwezo wa mashirika na taasisi za serikali kutambua na kutambua ndoa za jinsia moja.	Capacity and Resources	sw	2.0
Watetezi wa ndoa za jinsia moja wanahoji kuwa ni haki ya msingi ya binadamu na kuwanyima wapenzi wa jinsia moja haki ya kuoana ni kinyume cha maadili.	Morality	sw	3.0
Wapinzani wa ndoa za jinsia moja mara nyingi hujenga hoja zao katika misingi ya kidini au kimaadili, wakisema kwamba ndoa inapaswa kuwa kati ya mwanamume na mwanamke pekee.	Morality	sw	3.0
Uhalalishaji wa ndoa za watu wa jinsia moja mara nyingi huonekana kama suala la haki na usawa, na kuwapa wapenzi wa jinsia moja utambuzi wa kisheria na manufaa sawa na wapenzi wa jinsia tofauti.	Fairness and Equality	sw	4.0
Wapinzani wa ndoa za jinsia moja wanahoji kuwa huu si usawa kwa sababu wapenzi wa jinsia moja wanaweza kuingia katika ubia uliosajiliwa au wa jinsia moja, jambo ambalo linawapa haki za kisheria sawa na wanandoa.	Fairness and Equality	sw	4.0
Hali ya kisheria ya ndoa ya jinsia moja inatofautiana kulingana na mamlaka. Baadhi ya nchi na majimbo yanaihalalisha, wakati zingine haziihalalishi. Hili lilizua mjadala kuhusu masuala kama vile haki za majimbo na jukumu la serikali ya shirikisho katika kufafanua ndoa.	Legality, Constitutionality, Jurisdiction	sw	5.0
Wapinzani wa ndoa za watu wa jinsia moja kwa kawaida huhoji kuwa mataifa yanafaa kuamua kuihalalisha au kutoihalalisha, huku wanaoiunga mkono kwa kawaida wakisema kuwa ni suala la haki za kikatiba za shirikisho.	Legality, Constitutionality, Jurisdiction	sw	5.0
Wafuasi wa ndoa za watu wa jinsia moja wanaona kuhalalishwa kwa ndoa za watu wa jinsia moja kama hatua nzuri ya kisiasa kuelekea usawa na ushirikishwaji zaidi.	Policy Prescription and Evaluation	sw	6.0
Wapinzani wa ndoa za jinsia moja wanahoji kuwa ina matokeo mabaya ya kijamii na kitamaduni na haitoi suluhu la kisiasa kwa matatizo yanayowakabili wapenzi wa jinsia moja.	Policy Prescription and Evaluation	sw	6.0
Uhalalishaji wa ndoa za jinsia moja hauna matokeo ya jinai au adhabu.	Crime and Punishment	sw	7.0
Walakini, wapinzani wa ndoa za jinsia moja mara nyingi wanasema kwamba itaharibu maadili ya kitamaduni ya familia na maadili, ambayo wanasema yatakuwa na matokeo mabaya ya kijamii.	Crime and Punishment	sw	7.0
Uhalalishaji wa ndoa za watu wa jinsia moja hauna athari za kiusalama.	Security and Defense	sw	8.0
Lakini baadhi ya wapinzani wa ndoa za watu wa jinsia moja wanasema zinadhoofisha mifumo ya kitamaduni ya familia ambayo wanasema ni muhimu katika kuimarisha maadili ya kijamii na ulinzi wa taifa.	Security and Defense	sw	8.0
Uhalalishaji wa ndoa za watu wa jinsia moja umekuwa na athari chanya kwa afya na usalama kwa kuwapa wapenzi wa jinsia moja kupata manufaa muhimu ya kisheria na kiafya kama vile bima ya afya na kulazwa hospitalini.	Health and Safety	sw	9.0
Wapinzani wa ndoa za jinsia moja wanasema kuwa inaweza kuwa na athari mbaya kiafya, pamoja na:	Health and Safety	sw	9.0
Uhalalishaji wa ndoa za jinsia moja utakuwa na matokeo chanya katika ubora wa maisha ya wapenzi wa jinsia moja kwa kutoa utambuzi mkubwa wa kisheria na ufikiaji wa manufaa na rasilimali muhimu.	Quality of Life	sw	10.0
Wapinzani wa ndoa za jinsia moja mara nyingi wanasema kuwa inaharibu miundo na maadili ya jadi ya familia, na kuathiri vibaya ubora wa maisha ya watu binafsi na familia.	Quality of Life	sw	10.0
Ndoa za watu wa jinsia moja zinaweza kuonekana kama kielelezo cha kubadilisha mitazamo ya kitamaduni kuelekea haki na kukubalika kwa LGBTQ+.	Cultural Identity	sw	11.0
Wapinzani wa ndoa za jinsia moja mara nyingi hubishana juu ya uhifadhi wa maadili ya kitamaduni na kanuni.	Cultural Identity	sw	11.0
Maoni ya umma kuhusu ndoa za watu wa jinsia moja yamebadilika sana katika miaka ya hivi karibuni huku uungwaji mkono wa utambuzi wa kisheria wa mahusiano ya jinsia moja ukiongezeka.	Public Sentiment	sw	12.0
Hata hivyo, baadhi ya wanaopinga ndoa za jinsia moja wanasema kuwa maoni ya umma hayafai kuathiri maamuzi ya kisiasa na kwamba ndoa inapaswa kufafanuliwa kuwa ndoa kati ya mwanamume na mwanamke.	Public Sentiment	sw	12.0
Ndoa za watu wa jinsia moja ni suala la kisiasa sana, na vyama tofauti vya kisiasa na vikundi vya masilahi vinachukua misimamo tofauti juu ya suala hilo.	Political	sw	13.0
Uhalali wa ndoa za jinsia moja mara nyingi huwa suala la kisiasa wakati wa uchaguzi huku wagombea wakitoa maoni yao kwenye majukwaa yao.	Political	sw	13.0
Hali ya kisheria ya ndoa za watu wa jinsia moja inaweza kuathiri hadhi ya kimataifa ya nchi, hasa msimamo wake kuhusu haki za binadamu na masuala ya LGBTQ+.	External Regulation and Reputation	sw	14.0
Baadhi ya wapinzani wa ndoa za watu wa jinsia moja wanahoji kuwa inaharibu sura ya nchi na uhusiano wake na nchi nyingine.	External Regulation and Reputation	sw	14.0
Ndoa za watu wa jinsia moja huhusishwa na masuala mengine mengi kama vile kuasili na kulea watoto, ubaguzi na uhalifu wa chuki, na ukosefu wa usawa wa kiafya.	Other	sw	15.0
Mjadala unaohusu ndoa za watu wa jinsia moja ni mgumu na wenye sura nyingi, mara nyingi unahusisha makundi na mitazamo tofauti ya kimaslahi.	Other	sw	15.0
Uhamiaji una athari chanya na hasi katika uchumi, ingawa unachangia uchumi kupitia ajira na matumizi, pia hutumia rasilimali za umma.	Economic	sw	1.0
Baadhi wanahoji kuwa uhamiaji ni muhimu kwa ukuaji wa uchumi, hasa katika sekta zenye uhaba wa vibarua, huku wengine wakihoji kuwa husababisha wafanyakazi wa ndani kukosa kazi.	Economic	sw	1.0
Uhamiaji unaweka shinikizo kwa rasilimali za umma kama vile huduma za afya, elimu na makazi, haswa katika maeneo yenye idadi kubwa ya wahamiaji.	Capacity and Resources	sw	2.0
Lakini wengine wanahoji kuwa wahamiaji pia huleta ujuzi na uwezo unaonufaisha jamii na kusaidia kuendeleza mali hizo.	Capacity and Resources	sw	2.0
Maadili ya uhamiaji ni suala linalozua utata, huku wengine wakisema kuwa kutoa ulinzi na fursa kwa wanaohitaji ni jambo la kimaadili, huku wengine wakiona ni kinyume cha maadili kuwaruhusu wahamiaji wasio na vibali kubaki nchini humo.	Morality	sw	3.0
Mijadala kuhusu uhamiaji mara nyingi huhusu masuala ya haki na usawa. Baadhi wanahoji kuwa si haki kutanguliza mahitaji ya wahamiaji kuliko mahitaji ya wenyeji, huku wengine wakisema kuwa wahamiaji wanapaswa kuwa na fursa sawa bila kujali utaifa.	Fairness and Equality	sw	4.0
Uhalali wa uhamiaji ni suala tata kwani sheria na kanuni tofauti hutawala aina tofauti za uhamiaji na visa.	Legality, Constitutionality, Jurisdiction	sw	5.0
Baadhi wanachukulia sera ya uhamiaji kuwa kinyume na katiba au isiyo ya haki, huku wengine wakiona kuwa ni muhimu kuhakikisha na kulinda usalama wa taifa.	Legality, Constitutionality, Jurisdiction	sw	5.0
Ufanisi wa sera na programu mbalimbali za uhamiaji ni mada ya mjadala wa mara kwa mara, kwani washikadau tofauti hutoa masuluhisho tofauti kwa matatizo na fursa za uhamiaji.	Policy Prescription and Evaluation	sw	6.0
Tathmini ni muhimu ili kuhakikisha ufanisi na usawa wa sera na programu za uhamiaji.	Policy Prescription and Evaluation	sw	6.0
Uhusiano kati ya wahamiaji na uhalifu ni wa kutatanisha, huku wengine wakisema kuwa wahamiaji wana uwezekano mkubwa wa kufanya uhalifu na kusababisha tishio kwa usalama wa umma, huku wengine wakisema kuwa wahamiaji wana uwezekano mdogo wa kufanya uhalifu kuliko raia wa asili.	Crime and Punishment	sw	7.0
Uhamiaji una athari za usalama wa kitaifa na usalama wa kitaifa, haswa kwa kukagua na kukagua wahamiaji na kuzuia kuingia kwa vitisho vinavyowezekana.	Security and Defense	sw	8.0
Lakini wengine wanahoji kuwa sera za uhamiaji zenye vizuizi kupita kiasi zinaweza kuumiza uhusiano na nchi zingine na kupunguza fursa za ushirikiano na uvumbuzi.	Security and Defense	sw	8.0
Uhamiaji una athari za afya ya umma na usalama, haswa katika suala la kuenea kwa magonjwa na ufikiaji wa huduma za afya.	Health and Safety	sw	9.0
Hata hivyo, baadhi wanahoji kuwa utoaji wa huduma za afya na kijamii unaweza kuboresha matokeo ya afya ya umma kwa ujumla na kupunguza mzigo wa huduma za dharura.	Health and Safety	sw	9.0
Uhamiaji unaweza kuwa na athari chanya na hasi juu ya ubora wa maisha ya wahamiaji na wakaazi wa eneo hilo, kulingana na mambo kama vile hali ya kiuchumi, utangamano wa kijamii na utambulisho wa kitamaduni.	Quality of Life	sw	10.0
Wengine wanahoji kuwa uhamiaji unakuza utofauti na kubadilishana kitamaduni, huku wengine wakiamini kuwa umesababisha mgawanyiko wa kijamii na kiuchumi.	Quality of Life	sw	10.0
Uhamiaji huathiri utambulisho wa kitamaduni, haswa katika suala la lugha, mila na maadili.	Cultural Identity	sw	11.0
Baadhi wanahoji kuwa uhamiaji unaweza kuimarisha na kubadilisha uzoefu wa kitamaduni, huku wengine wakisema kuwa unaweza kudhoofisha utambulisho wa kitaifa na uwiano wa kijamii.	Cultural Identity	sw	11.0
Maoni ya umma juu ya uhamiaji yaligawanywa, huku wengine wakionyesha kuunga mkono uhamiaji zaidi, wengine wakitaka udhibiti na vizuizi zaidi.	Public Sentiment	sw	12.0
Jinsi vyombo vya habari na wanasiasa wanavyowaonyesha wahamiaji vinaweza kuathiri maoni ya umma na maamuzi ya kisiasa.	Public Sentiment	sw	12.0
Uhamiaji ni suala la kisiasa sana na vyama tofauti vya siasa na vikundi vya masilahi vinachukua misimamo tofauti juu ya suala hilo.	Political	sw	13.0
Mjadala wa uhamiaji mara nyingi huwa suala la kisiasa wakati wa uchaguzi, huku wagombea wakichukua misimamo kwenye suala hilo kwenye majukwaa yao.	Political	sw	13.0
Jinsi nchi inavyoshughulikia uhamiaji inaweza kuathiri sifa na uhusiano wake na nchi zingine, haswa linapokuja suala la haki za binadamu na sheria za kimataifa.	External Regulation and Reputation	sw	14.0
Mifumo ya uhamiaji pia huathiriwa na shinikizo za nje na sheria za mashirika na mikataba ya kimataifa.	External Regulation and Reputation	sw	14.0
Masuala mengine ya uhamiaji ni pamoja na athari kwa mienendo ya familia, jukumu la wahamiaji katika kuunda mwelekeo wa idadi ya watu na kubadilishana kitamaduni, na ujumuishaji wa wahamiaji katika jamii.	Other	sw	15.0
Masuala haya yana athari kubwa kwa mienendo ya kijamii, kiuchumi na kisiasa ya nchi.	Other	sw	15.0
Ndoa za watu wa jinsia moja zinaweza kuwa na matokeo chanya ya kiuchumi kupitia maendeleo ya biashara za ndani na utalii, pamoja na kuongezeka kwa mapato ya serikali.	Economic	sw	1.0
Wapinzani wanasema ndoa za watu wa jinsia moja zinavuruga ndoa za kitamaduni na miundo ya familia na kuathiri uchumi.	Economic	sw	1.0
Kuhalalisha ndoa za watu wa jinsia moja kutaongeza uwezo wa wapenzi wa jinsia moja kupata rasilimali na manufaa kama vile huduma za afya na haki za wazazi.	Capacity and Resources	sw	2.0
Wakosoaji wanasema kuwa ndoa za watu wa jinsia moja zinahitaji rasilimali na nguvu, kwani zinahitaji mabadiliko katika mfumo wa kisheria na taasisi.	Capacity and Resources	sw	2.0
Watetezi wa ndoa za jinsia moja wanasema kwamba kutambua haki sawa na utu wa watu wote bila kujali mwelekeo wa kijinsia ni sharti la kimaadili.	Morality	sw	3.0
Wapinzani wanasema kuwa ndoa za watu wa jinsia moja ni kinyume cha maadili na inakiuka maadili ya kitamaduni ya kidini na kitamaduni.	Morality	sw	3.0
Ndoa ya watu wa jinsia moja inachukuliwa kuwa suala muhimu la haki na usawa kwa watu wa LGBTQ+, linalotoa haki sawa na ulinzi wa kisheria kama wapenzi wa jinsia tofauti.	Fairness and Equality	sw	4.0
Wakosoaji wanasema kuwa ndoa za watu wa jinsia moja si suala la usawa kwani linahitaji kufafanuliwa upya kwa fasili ya kitamaduni ya ndoa.	Fairness and Equality	sw	4.0
Uhalali wa ndoa za jinsia moja umejadiliwa katika mahakama na serikali zikitofautiana katika tafsiri ya kikatiba na maoni ya mahakama.	Legality, Constitutionality, Jurisdiction	sw	5.0
Wapinzani wanahoji kuwa ndoa za watu wa jinsia moja hazifai kuhalalishwa kwa sababu hakuna Katiba wala mfano unaoamuru kwa uwazi ndoa za jinsia moja.	Legality, Constitutionality, Jurisdiction	sw	5.0
Chaguzi za sera za ndoa za jinsia moja hutofautiana kulingana na mambo ya kisiasa na kitamaduni. Katika baadhi ya nchi ni kuhalalishwa, kwa wengine ni marufuku.	Policy Prescription and Evaluation	sw	6.0
Kutathmini athari za kijamii na kibinafsi za ndoa za watu wa jinsia moja ni mchakato unaoendelea, huku utafiti ukionyesha matokeo chanya na hasi.	Policy Prescription and Evaluation	sw	6.0
Katika baadhi ya maeneo ndoa za watu wa jinsia moja huharamishwa na watu hukabiliwa na vikwazo vya kisheria au unyanyapaa wa umma kwa uhusiano wa jinsia moja.	Crime and Punishment	sw	7.0
Juhudi za kuhalalisha ndoa za watu wa jinsia moja mara nyingi huonekana kama njia ya kukomesha ubaguzi na adhabu kulingana na mwelekeo wa kijinsia.	Crime and Punishment	sw	7.0
Ndoa za watu wa jinsia moja zimetumika kama nyenzo ya kukuza usalama wa taifa na haki za binadamu, haswa katika muktadha wa uhusiano wa kimataifa na diplomasia.	Security and Defense	sw	8.0
Wakosoaji wanaamini kuwa ndoa za watu wa jinsia moja hudhoofisha taasisi ya ndoa na familia na huathiri vibaya usalama wa taifa na utulivu wa kijamii.	Security and Defense	sw	8.0
Kuhalalisha ndoa za watu wa jinsia moja kunaweza kuboresha afya na usalama wa watu wa LGBTQ+ kwa kuwapa ufikiaji wa huduma za afya, bima na ulinzi wa kisheria.	Health and Safety	sw	9.0
Wapinzani wanasema kuwa ndoa za jinsia moja ni hatari kwa afya ya binadamu na jamii, hivyo kusababisha kuenea kwa magonjwa na matokeo mengine mabaya.	Health and Safety	sw	9.0
Kwa sababu ya kutambuliwa kisheria na kijamii kwa watu wa LGBTQ+, ndoa ya watu wa jinsia moja inachukuliwa kuwa jambo muhimu katika kuboresha maisha ya watu wa LGBTQ+.	Quality of Life	sw	10.0
Wakosoaji wanasema kuwa ndoa za watu wa jinsia moja hudhoofisha maadili na miundo ya kitamaduni, na kuathiri vibaya ubora wa maisha ya watu binafsi na jamii.	Quality of Life	sw	10.0
Ndoa za watu wa jinsia moja inachukuliwa kuwa suala kuu la utambulisho wa kitamaduni wa LGBTQ+ kwani inawakilisha utambuzi wa kimsingi wa uwepo na haki zao katika jamii.	Cultural Identity	sw	11.0
Wapinzani wanasema kuwa ndoa za watu wa jinsia moja zinatishia utambulisho wa kitamaduni na maadili na zinaweza kusababisha kuzorota kwa kijamii na kimaadili.	Cultural Identity	sw	11.0
Baada ya muda, maoni ya umma kuhusu ndoa za watu wa jinsia moja yamebadilika, huku nchi na maeneo mengi zaidi yakikubali na kuunga mkono ndoa za jinsia moja.	Public Sentiment	sw	12.0
Msukumo wa kuhalalisha ndoa za watu wa jinsia moja mara nyingi huchochewa na maoni ya umma kwani wanasiasa na mashirika hujibu mabadiliko ya mitazamo na mawazo.	Public Sentiment	sw	12.0
Suala la ndoa za jinsia moja mara nyingi ni la kisiasa, huku vyama vya siasa na wanasiasa wakiwa na misimamo tofauti kulingana na maadili na itikadi zao.	Political	sw	13.0
Uhalalishaji wa ndoa za watu wa jinsia moja limekuwa suala kuu la kisiasa kwa wanaharakati wa haki za LGBTQ+, ambao wanaona kama njia ya kufikia usawa zaidi wa kijamii na kisheria.	Political	sw	13.0
Ndoa za watu wa jinsia moja mara nyingi huonekana kama kipimo cha dhamira ya nchi katika maendeleo ya kijamii na haki za binadamu, lakini makundi ya kimataifa na washirika wao wanaishawishi serikali kuihalalisha.	External Regulation and Reputation	sw	14.0
Wapinzani wanahoji kuwa shinikizo la nje la kuhalalisha ndoa za watu wa jinsia moja linakiuka mamlaka ya kitaifa na maadili ya kitamaduni.	External Regulation and Reputation	sw	14.0
Ndoa za watu wa jinsia moja ni suala lenye utata na kihisia, huku watu binafsi na makundi ya pande zote mbili wakipigania imani na maadili yao.	Other	sw	15.0
Mjadala unaohusu ndoa za watu wa jinsia moja ni mgumu na wenye sura nyingi, unaonyesha mivutano mipana ya kijamii na kitamaduni kuhusu utambulisho, maadili na mamlaka.	Other	sw	15.0
Uhamiaji una athari chanya na hasi za kiuchumi, huku wengine wakisema kuwa huleta kazi na ujuzi muhimu, huku wengine wakisema kuwa unashusha mishahara na kuumiza huduma za kijamii.	Economic	sw	1.0
Kampuni nyingi hutegemea wafanyikazi wahamiaji, haswa katika sekta kama vile kilimo, ukarimu na ujenzi.	Economic	sw	1.0
Uhamiaji huweka shinikizo kwa miundombinu na rasilimali za nchi kama vile makazi, usafiri na huduma za afya, hasa katika maeneo yenye mahitaji makubwa ya huduma.	Capacity and Resources	sw	2.0
Nchi nyingi hupunguza idadi ya wahamiaji wanaoweza kukubali kulingana na rasilimali zao na uwezo wa kutoa msaada.	Capacity and Resources	sw	2.0
Wengine huona uhamiaji kuwa wajibu wa kimaadili kusaidia wale walio na uhitaji, hasa wakimbizi wanaokimbia jeuri au mateso katika nchi zao.	Morality	sw	3.0
Wengine wanahoji kuwa kuruhusu wahamiaji kuingia kinyume cha sheria au kuwanyonya wafanyakazi wahamiaji ni kinyume cha maadili.	Morality	sw	3.0
Wengi wanahoji kuwa sera ya uhamiaji inapaswa kuzingatia kanuni za haki na usawa na kwamba wahamiaji wanapaswa kutendewa kwa utu na heshima.	Fairness and Equality	sw	4.0
Wengine wanasema kuwa kupendelea wahamiaji kuliko raia sio haki na sio haki.	Fairness and Equality	sw	4.0
Sera ya uhamiaji inakabiliwa na changamoto za kisheria na kikatiba, hasa katika masuala ya uraia, kufukuzwa nchini na hifadhi.	Legality, Constitutionality, Jurisdiction	sw	5.0
Nchi nyingi zina tofauti za kimamlaka, huku serikali za mitaa, majimbo na shirikisho zikicheza jukumu katika sera ya uhamiaji.	Legality, Constitutionality, Jurisdiction	sw	5.0
Sera ya uhamiaji mara nyingi huamuliwa na uundaji na tathmini ya sera, ambapo wataalam na watunga sera hupima gharama na manufaa ya mbinu tofauti.	Policy Prescription and Evaluation	sw	6.0
Baadhi wanahoji kuwa mkakati huo unapaswa kutegemea ushahidi na data, huku wengine wakisisitiza sababu za kinadharia au kisiasa.	Policy Prescription and Evaluation	sw	6.0
Sera ya uhamiaji mara nyingi inahusishwa na masuala ya uhalifu na adhabu, na wengine wanahoji kuwa wahamiaji wana uwezekano mkubwa wa kufanya uhalifu na wanapaswa kudhibitiwa zaidi.	Crime and Punishment	sw	7.0
Wengine wanahoji kuwa wahamiaji wananyanyaswa isivyo haki na kwamba sera zinafaa kulenga kupunguza uhalifu na kuboresha usalama wa umma kwa wakaazi wote.	Crime and Punishment	sw	7.0
Sera ya uhamiaji inaathiri usalama na ulinzi wa nchi, hasa kuhusiana na masuala ya udhibiti wa mipaka na utambulisho wa taifa.	Security and Defense	sw	8.0
Baadhi wanaona uhamiaji kuwa tishio kwa usalama wa taifa, ilhali wengine wanaona kuwa ni muhimu kudumisha jamii yenye tamaduni nyingi.	Security and Defense	sw	8.0
Sera ya uhamiaji ina athari kwa afya na usalama wa umma, haswa kuhusiana na udhibiti wa magonjwa na maswala ya kukabiliana na dharura.	Health and Safety	sw	9.0
Baadhi wanahoji kuwa sera ya uhamiaji inapaswa kutanguliza afya na usalama wa umma, huku wengine wakisema kuwa sera inapaswa kutanguliza mahitaji ya wahamiaji na wakimbizi.	Health and Safety	sw	9.0
Sera ya uhamiaji inaathiri ubora wa maisha ya wahamiaji na wananchi, hasa katika suala la uwiano wa kijamii, elimu na ajira.	Quality of Life	sw	10.0
Baadhi wanahoji kuwa uhamiaji huboresha ubora wa maisha kwa kutoa mitazamo na ujuzi tofauti, huku wengine wakisema kuwa huleta mvutano wa kijamii na migogoro.	Quality of Life	sw	10.0
Sera ya uhamiaji mara nyingi huhusishwa na masuala ya utambulisho wa kitamaduni, na wengine wanaona uhamiaji kama tishio kwa utambulisho wa kitaifa na urithi wa kitamaduni.	Cultural Identity	sw	11.0
Wengine wanahoji kuwa utambulisho wa kitamaduni unabadilika kila mara na kwamba uhamiaji unaweza kuboresha na kubadilisha usemi wa kitamaduni.	Cultural Identity	sw	11.0
Sera ya uhamiaji mara nyingi inaendeshwa na hisia na mitazamo ya umma kuhusu uhamiaji, na baadhi ya kutetea vikwazo vikali na wengine kwa sera pana.	Public Sentiment	sw	12.0
Sababu nyingi huathiri maoni ya umma, ikiwa ni pamoja na utangazaji wa vyombo vya habari, mazungumzo ya kisiasa, na uzoefu wa kibinafsi.	Public Sentiment	sw	12.0
Sera ya uhamiaji mara nyingi huathiriwa na maoni ya kisiasa, huku vyama tofauti vya kisiasa na vikundi vya masilahi vinachukua nafasi tofauti kulingana na maadili na maadili yao.	Political	sw	13.0
Sera ya uhamiaji inaweza kuwa suala tofauti la kisiasa ambalo wanasiasa hutumia kuhamasisha msingi wao na kuwavutia wapiga kura kutoka idadi tofauti ya watu.	Political	sw	13.0
Sera ya uhamiaji inaweza kuathiri udhibiti wa nje na sifa ya nchi, haswa katika eneo la haki za binadamu na sheria za kimataifa.	External Regulation and Reputation	sw	14.0
Wengine wanahoji kwamba uhamiaji unatishia utambulisho wa kitamaduni wa nchi kwa kuanzisha mila na imani mpya. Wengine, hata hivyo, wanahoji kuwa utofauti unaboresha utamaduni wa jamii na unapaswa kuhimizwa.	Cultural Identity	sw	11.0
Ni muhimu kwa wahamiaji kuelewa na kuheshimu utambulisho wa kitamaduni wa nchi wanazotembelea na kuhifadhi na kushiriki urithi wao wa kipekee wa kitamaduni.	Cultural Identity	sw	11.0
Mtazamo wa umma wa uhamiaji hutofautiana kulingana na eneo na muktadha. Katika baadhi ya mikoa, wahamiaji wanakaribishwa na kuthaminiwa kwa huduma wanazotoa kwa jamii, wakati katika mikoa mingine watu wanaweza kuogopa au kuchukizwa kwamba wahamiaji wanachukua kazi au rasilimali zao.	Public Sentiment	sw	12.0
Vyombo vya habari vina jukumu la kuunda mitazamo ya jamii kuhusu wahamiaji, kwani hadithi za kusisimua za uhalifu wa wahamiaji huchangia mitazamo hasi dhidi ya wahamiaji.	Public Sentiment	sw	12.0
Sera ya uhamiaji mara nyingi huchochewa kisiasa: wanasiasa hujaribu kushinda kura kwa kuwaomba wafuasi wao au kwa kuchukua msimamo mkali kuhusu uhamiaji.	Political	sw	13.0
Mahusiano ya kimataifa yanaweza pia kuathiri sera ya uhamiaji ya nchi kwa vile masuala ya kidiplomasia na makubaliano huathiri mtiririko wa wahamiaji.	Political	sw	13.0
Mashirika na mikataba ya kimataifa kama vile Umoja wa Mataifa na Umoja wa Ulaya ina jukumu katika kudhibiti na kuunda sera ya uhamiaji.	External Regulation and Reputation	sw	14.0
Sifa ya nchi kama ukaribishaji-wageni au chuki dhidi ya wahamiaji ina athari muhimu za kiuchumi na kisiasa zinazoathiri utalii, biashara na uhusiano wa kidiplomasia.	External Regulation and Reputation	sw	14.0
Uhamiaji unaweza kuwa na athari chanya na hasi za kiuchumi kwa nchi, kwa mfano kwa kutoa wafanyikazi wa bei nafuu na kuongeza ushindani wa kazi na rasilimali.	Economic	sw	1.0
Uwezo wa nchi wa kukubali na kusaidia wahamiaji hupunguzwa na uwezo wake wa makazi, elimu, huduma za afya, na rasilimali nyinginezo.	Capacity and Resources	sw	2.0
Masuala ya kimaadili ya uhamiaji yanajumuisha maswali kuhusu haki za wahamiaji na wajibu wa nchi zinazowahifadhi.	Morality	sw	3.0
Sera ya uhamiaji lazima iwe ya haki na ya haki, kutoa fursa sawa kwa wahamiaji wote.	Fairness and Equality	sw	4.0
Sheria na sera za uhamiaji lazima zifuate kanuni za kisheria na kikatiba, na serikali ina jukumu la kuzitekeleza.	Legality, Constitutionality, Jurisdiction	sw	5.0
Sera madhubuti ya uhamiaji inahitaji kuzingatiwa kwa kina na kuzingatia malengo, athari na mikakati ya utekelezaji.	Policy Prescription and Evaluation	sw	6.0
Uhamiaji unaweza kuhusishwa na uhalifu na masuala ya uhalifu, ikiwa ni pamoja na usalama wa mpaka na shughuli za uhalifu zinazohusiana na uhamiaji.	Crime and Punishment	sw	7.0
Sera ya uhamiaji inaathiri usalama na ulinzi wa taifa, ikijumuisha vitisho vinavyoweza kutokea kutoka kwa makundi ya kigaidi na mizozo ya kijiografia na kisiasa.	Security and Defense	sw	8.0
Afya na usalama wa wahamiaji na jumuiya zinazowapokea zinapaswa kuzingatiwa katika sera ya uhamiaji, ikiwa ni pamoja na masuala kama vile udhibiti wa magonjwa na usafi.	Health and Safety	sw	9.0
Uhamiaji huathiri ubora wa maisha ya wahamiaji na jumuiya zinazowakaribisha, na kuathiri uwiano wa kijamii, huduma za umma na ushirikiano wa kitamaduni.	Quality of Life	sw	10.0
Uhamiaji huunda utambulisho wa kitamaduni wa nchi na watu wao, na athari chanya na hasi kwa anuwai na mshikamano wa kijamii.	Cultural Identity	sw	11.0
Mitazamo ya umma na mitazamo ya uhamiaji ina athari muhimu za kisiasa na kijamii.	Public Sentiment	sw	12.0
Sera ya uhamiaji mara nyingi huathiriwa na masuala ya kisiasa kama vile mikakati ya uchaguzi na itikadi ya chama.	Political	sw	13.0
Mashirika na mikataba ya kimataifa ina jukumu katika kuunda na kudhibiti sera za uhamiaji zinazoathiri sifa ya nchi na nafasi ya kimataifa.	External Regulation and Reputation	sw	14.0
Ndoa za watu wa jinsia moja ni suala la kimaadili na la kimaadili, na kumnyima mtu haki ya kuoa kwa sababu ya mwelekeo wake wa kijinsia ni ubaguzi na si haki.	Morality	sw	3.0
Watu wote, bila kujali mwelekeo wa kijinsia, wanapaswa kuwa na haki ya kuoana na haki sawa na ulinzi wa kisheria kama wapenzi wa jinsia tofauti.	Fairness and Equality	sw	4.0
Si haki na ni kinyume cha maadili kuwanyima watu haki ya kuoa kwa sababu ya mwelekeo wao wa kijinsia.	Morality	sw	3.0
Watu wote, bila kujali mwelekeo wa kijinsia, wanapaswa kuwa na haki ya kuoana na haki sawa na ulinzi wa kisheria kama wapenzi wa jinsia tofauti.	Fairness and Equality	sw	4.0
Kukubalika na mitazamo kuelekea ndoa za watu wa jinsia moja imebadilika kadiri muda unavyopita katika sehemu nyingi za dunia, lakini vizuizi muhimu vya kitamaduni na kijamii bado vinapaswa kuondolewa.	Public Sentiment	sw	12.0
Sera na sheria za ndoa za watu wa jinsia moja zina athari kubwa kwa jamii, na ni muhimu kutathmini athari zao na kufanya mabadiliko yanayohitajika ili kuhakikisha haki na usawa.	Policy Prescription and Evaluation	sw	6.0
Kuhalalishwa kwa ndoa za jinsia moja kuna faida za kiuchumi kwani huongeza utalii na kutengeneza nafasi mpya za kazi katika tasnia ya harusi.	Economic	sw	1.0
Ingawa ndoa za watu wa jinsia moja zinaweza kupinga mawazo ya kitamaduni ya majukumu ya kijinsia na kanuni za kijamii, inaonekana na wengine kama kukuza utambulisho wa kitamaduni tofauti na unaokubalika.	Cultural Identity	sw	11.0
Kuwanyima wapenzi wa jinsia moja haki ya kuoana kunaathiri vibaya afya na ustawi wao huku wakikabiliwa na ubaguzi na kukosa kupata suluhu muhimu za kisheria na kiuchumi.	Health and Safety	sw	9.0
Mjadala kuhusu ndoa za jinsia moja ni suala muhimu la kisiasa katika nchi nyingi, ambapo vyama vya siasa na wanasiasa huchukua misimamo tofauti kulingana na imani zao na maoni ya wapiga kura.	Political	sw	13.0
Uhalalishaji wa ndoa za watu wa jinsia moja ni hatua muhimu kuelekea usawa wa jumuiya ya LGBTQ+ na inahakikisha haki na fursa sawa na wapenzi wa jinsia tofauti.	Fairness and Equality	sw	4.0
Kwa wengi, ndoa za watu wa jinsia moja ni suala la kimaadili, wengine wanasema linaenda kinyume na maadili ya kitamaduni, huku wengine wakisisitiza kusherehekea mapenzi na usuhuba bila kujali jinsia.	Morality	sw	3.0
Kuwanyima watu wa jinsia moja haki ya kuoana ni ukiukaji wa wazi wa haki za msingi za binadamu kama vile usawa na kutobaguliwa.	Fairness and Equality	sw	4.0
Ndoa ya watu wa jinsia moja huwapa wanandoa manufaa muhimu ya kiafya, ikiwa ni pamoja na: B. Manufaa ya kimatibabu, bima, na upatikanaji wa huduma muhimu za matibabu inapotokea ugonjwa au huduma ya dharura.	Health and Safety	sw	9.0
Afisa anayefahamu rasimu ya bajeti alitoa maelezo ya ombi la ufadhili kabla ya Rais Biden kutangaza mpango huo Jumatatu kwa sharti la kutotajwa jina.	Capacity and Resources	sw	2.0
ICE itaendelea kufuatilia vituo vya watu binafsi vya kizuizini ili kuhakikisha mazingira yanayofaa kwa ushirikiano na ERO, OPR, na mashirika mengine ya udhibiti ndani ya Idara ya Usalama wa Nchi.	Capacity and Resources	sw	2.0
HSI ilifanya kazi na FBI kupata Idara ya Haki kuwasilisha mashtaka dhidi ya washirika hao wawili.	Capacity and Resources	sw	2.0
Huratibu usimamizi wa kizuizini na ofisi 25 za uwanja wa ERO ili kutoa mazingira salama kwa wasio raia walio chini ya ulinzi wa ICE kupitia kufuata kituo, ufuatiliaji wa shamba na ununuzi wa vituo vya kizuizini.	Capacity and Resources	sw	2.0
25 Ofisi ya Maeneo ya ERO huwezesha usaidizi wa vifaa na uendeshaji kwa shughuli za kukwepa kodi kwa kuandaa, kutekeleza na kufuatilia mipango na taratibu zinazosaidia dhamira ya Mpango Kazi wa Kuepuka Ushuru nchini kote.	Capacity and Resources	sw	2.0
Vituo hivi vinatumia utaalam wa kiufundi, zana za uchanganuzi na tajriba ya utekelezaji wa sheria ili kuandaa mapendekezo ya kuwafurusha watu wasio raia kulingana na kijasusi.	Capacity and Resources	sw	2.0
Kupitia ukusanyaji wa data, uchanganuzi na uboreshaji wa teknolojia na mchakato, LESA hutoa zana, utafiti na mapendekezo ili kusaidia kufanya maamuzi na kupanga kwa ICE.	Capacity and Resources	sw	2.0
Kwa kufanya kazi na wadau wa mawakala na mashirika mengine, balozi za kigeni na balozi ndogo, na washirika wa kimataifa, kitengo hiki hutengeneza na kutekeleza mikakati ya kuwafukuza raia wasio Wamarekani wanaosubiri kufukuzwa.	Capacity and Resources	sw	2.0
Tunaunga mkono sera za kimataifa za haki za binadamu na ulinzi wa wahamiaji na wakimbizi na tunataka hatua za kimataifa kushughulikia vyanzo vya uhamiaji, ikiwa ni pamoja na mabadiliko ya hali ya hewa.	Capacity and Resources	sw	2.0
Shirika lisilo la faida ambalo linakidhi viwango vya ustahiki vya PA, jimbo, na programu na lina mamlaka ya usimamizi ya kusimamia programu zilizoteuliwa na fedha za programu kwa niaba ya CDSS.	Capacity and Resources	sw	2.0
Iwapo uko Marekani bila ruhusa au msamaha kutoka kwa afisa wa uhamiaji, kukaa kwako kinyume cha sheria kunaanza tarehe uliyoingia nchini bila ruhusa au msamaha.	Crime and Punishment	sw	7.0
Kwa ujumla, ikiwa umekubaliwa Marekani au umezuiliwa na afisa wa uhamiaji, utapokea Fomu I-94, Rekodi ya Kuwasili/Jaribio, yenye tarehe kamili unayonuia kuondoka nchini.	Crime and Punishment	sw	7.0
Ukiondoka Marekani baada ya kuanza kwa mchakato wa uhamisho, ikiwa ni pamoja na kuondolewa kwa hiari, ni lazima uarifu Ofisi ya Utawala ya Uhamiaji.	Crime and Punishment	sw	7.0
Mstari wa miaka 10 pia utatumika ikiwa utaondoka kabla, wakati, au baada ya kutoandikishwa kwako kwa DHS kuanza.	Crime and Punishment	sw	7.0
Kwa hivyo, unaweza kutuma ombi tena la kibali cha kuingia Marekani hata kama hutakubaliwa kabisa, lakini tu ikiwa hujawahi kuwepo Marekani kwa angalau miaka 10 tangu kuondoka kwako mara ya mwisho. .	Crime and Punishment	sw	7.0
Kulingana na manufaa ya uhamiaji unayoomba, sheria inaweza kukuondoa kwenye mpango.	Crime and Punishment	sw	7.0
"Ni lazima uandike ""nimerejeshwa Marekani ndani ya miaka mitatu hadi kumi inavyotakiwa na sheria"" ili kurahisisha utambuzi na kuepuka ucheleweshaji wa kufuta faili."	Crime and Punishment	sw	7.0
Sheria ya Uhamiaji na Uraia (INA) inaweka misingi ya kutokubalika kwa mtu.	Crime and Punishment	sw	7.0
Kuna wahamiaji haramu wachache wahalifu huko Texas kwa sababu wahamiaji haramu hawatambuliki kwa miaka.	Crime and Punishment	sw	7.0
Wahamiaji, ikiwa ni pamoja na wasio raia wa Uhispania, wana uwezekano mdogo wa kuripoti uhalifu kuliko wenyeji, kulingana na Utafiti wa Kitaifa wa Kuripoti Uhalifu, ambao umeundwa kupima utayari wa watu kuripoti uhalifu.	Crime and Punishment	sw	7.0
Uigaji ni mchakato ambao kikundi au utamaduni wa wachache hukubali tabia, maadili, desturi na imani za kundi la walio wengi katika nchi mwenyeji.	Cultural Identity	sw	11.0
"Neno ""assimilation"" mara nyingi hutumiwa kuelezea wahamiaji wanaohamia mahali papya. Walakini, hutumiwa pia kujadili makabila."	Cultural Identity	sw	11.0
Watu wa kiasili, wahamiaji, na makabila madogo mara nyingi hubadilisha au kuficha vipengele vya tamaduni zao, ikiwa ni pamoja na lugha, chakula, mavazi, na mazoea ya kiroho, ili kupitisha maadili na tabia ya kijamii ya tamaduni kuu.	Cultural Identity	sw	11.0
Ni muhimu kukumbuka kwamba ushirikiano wa hiari mara nyingi ni jibu kwa shinikizo kutoka kwa utamaduni unaotawala zaidi, na kwamba kukabiliana na hali ni ufunguo wa kuwaweka watu hai na salama. Uigaji wa kulazimishwa: Hii ni hali ambapo watu wachache au kabila wanalazimishwa kuwasilisha. Utambulisho wao wa kitamaduni, lugha, mila na tamaduni zinalingana na kundi kubwa.	Cultural Identity	sw	11.0
Ingawa huu ulikuwa mchakato wa kawaida miongoni mwa majimbo, lilikuja kuwa suala lenye utata wa kisiasa, huku baadhi ya wanasiasa na umma siku za nyuma wakibishana kuwa wahamiaji wa Ulaya walichukuliwa kwa kasi zaidi kuliko walio wachache.	Cultural Identity	sw	11.0
Leo na huko nyuma, wazungu wengi katika nchi hii wanawaona wahamiaji na walio wachache kuwa tishio kwa utamaduni wa taifa, wakiogopa tofauti zetu na kutoa shinikizo la moja kwa moja na lisilo la moja kwa moja, ikiwa ni pamoja na vitisho, kwa wale ambao hawakubaliani. na vurugu.	Cultural Identity	sw	11.0
Uigaji wa kitamaduni ulikusudiwa kupunguza kujitenga, lakini katika kipindi hiki, wahamiaji walihimizwa kuiga kwa utulivu wa kijamii na ustawi wa kiuchumi.	Cultural Identity	sw	11.0
Uchunguzi mwingine wa kaya za wahamiaji uligundua kwamba ndugu wengi zaidi waliozaliwa katika nchi za kigeni walikuwa na uwezekano mkubwa wa kukosa kazi, kumaliza shule katika miaka michache, kupata kipato kidogo, na kuolewa na wenzi wazaliwa wa kigeni.	Cultural Identity	sw	11.0
Ingawa kulazimishwa kuiga ni aina ya unyanyasaji, kulazimisha watu wachache kufuata tamaduni za kigeni ni bora na mbaya zaidi.	Cultural Identity	sw	11.0
Watu wa kiasili, makabila madogo madogo, na wahamiaji mara nyingi hupitia uigaji kwa njia tofauti, kwa hivyo ni muhimu kujadili kwa uangalifu na kufikiria jinsi uigaji huu ulifanyika na matokeo yake.	Cultural Identity	sw	11.0
Katika sekta ya ukarimu, 38% ya wamiliki wa biashara walizaliwa nje ya Marekani, ikilinganishwa na 24% ya wamiliki wa maduka.	Economic	sw	1.0
Huku Waamerika milioni 85 wakiishi katika kaunti ambazo zilipoteza umri wao mkuu wa kufanya kazi kati ya 2011 na 2021, na milioni 160 wanaoishi katika kaunti zenye idadi ya watu inayopungua au tulivu, ni wakati wa kuanza kuzungumza tena kuhusu jinsi uhamiaji unavyohusiana na uchumi wa ndani na wa kikanda. .	Economic	sw	1.0
Kaunti 20 zenye watu wengi zaidi nchini Marekani zinachukua 36% ya wahamiaji walio na angalau elimu ya chuo kikuu, ikilinganishwa na 19% ya jumla ya idadi ya watu.	Economic	sw	1.0
Watunga sera wa serikali na wa ndani, haswa, wanapaswa kuunda mfumo wa kuelewa vyema kwa nini wahamiaji ni muhimu kwa Amerika na ni thamani gani inayoletwa na wahamiaji kwa jamii zao.	Economic	sw	1.0
Uwekezaji wa chini wa TEA uliongezeka hadi $900,000 (kutoka $500,000) ili kurekebisha mfumuko wa bei.	Economic	sw	1.0
DHS hufuata ratiba [DHS/USCIS/ICE/CBP-001 Hati Zigeni na Mfumo wa Kitaifa wa Kufuatilia Hati, Mfumo wa Taarifa ya Manufaa DHS/USCIS-007 na Biometrics ya Uhamiaji ya DHS/USCIS-018 na Curriculum Vitae] na hutoa Sera ya Faragha ya Tathmini ya Athari [ DHS] . Kutoka]. ] uchapishaji. /USCIS/PIA-016(a) Mifumo ya Maombi na Taarifa ya Kompyuta], inapatikana katika www.dhs.gov/privacy.	Economic	sw	1.0
Hata tofauti ya mishahara ya asilimia 10 kwa safari ya kwenda na kurudi ya mwaka inaruhusu wafanyakazi hawa wasio na ujuzi kupata kazi nchini Marekani badala ya kwenda nyumbani. Mpango mzuri, uliopangwa vyema, na unaotekelezwa vyema wa kupunguza umaskini unaweza kuongeza mapato hadi mara 35 ya ulivyoanza.	Economic	sw	1.0
Lakini pengo la sasa la mishahara na mahitaji yasiyopingika ya kazi kati ya nchi tajiri na maskini ina maana kwamba harakati zozote za watu hufanyika bila haki za kisheria na bila msaada wa waajiri.	Economic	sw	1.0
Athari za uhamiaji kwenye mishahara ni mbaya kwa kazi zilizo na wafanyikazi wa nyumbani wenye elimu duni na viwango vya juu vya wahamiaji. 4 Uhamiaji huathiri ajira na mishahara. Fursa kwa wafanyakazi wa ndani.	Economic	sw	1.0
Ongezeko la wahamiaji liliongeza ushindani wa ajira, na hivyo kusababisha kupungua kwa nafasi za ajira kwa wafanyakazi wa majumbani. Hata hivyo, uhamiaji ulikuwa na athari ndogo kwenye fursa za ajira. 6 Madhara halisi ya uhamiaji kwenye uchumi wa Marekani ni chanya. 7 Wahamiaji huongeza idadi ya watu walioajiriwa katika uchumi, na hivyo kusababisha ukuaji mkubwa wa uchumi na mishahara ya juu kwa wafanyikazi wa nyumbani.	Economic	sw	1.0
Sheria mpya huwapa wanaotafuta hifadhi fursa zaidi ya kusikiliza na kutoa uamuzi kwa wanaotafuta hifadhi (kesi hiyo kwa kawaida hurejeshwa kwa majaji wa uhamiaji) wanapojitokeza kwenye mpaka wa kusini wa Marekani.	External Regulation and Reputation	sw	14.0
Kiashiria cha Utawala wa Uhamiaji (MGI) hutoa mfumo wa kutathmini uadilifu wa sera za kitaifa za uhamiaji na kwa kutambua mapungufu na vipaumbele kwa ajili ya kujenga uwezo wa kitaasisi na programu za uhamiaji.	External Regulation and Reputation	sw	14.0
Vigezo vidogo mbalimbali vya kila aina ya sera huzingatiwa, ikijumuisha ustahiki, masharti, dhamana ya hali na haki zinazohusiana.	External Regulation and Reputation	sw	14.0
Jopo hilo limepangwa katika vipengele vitano vya sera: uwiano wa kitaasisi, kupunguza gharama za uhamiaji, kulinda haki za wahamiaji na familia, kuhimiza ujumuishaji na ujumuishaji upya, na kuongeza athari za maendeleo ya uhamiaji.	External Regulation and Reputation	sw	14.0
Sheria za uhamiaji zimo katika Kichwa cha 8 cha Kanuni za Kanuni za Shirikisho (Wageni na Raia), ambacho ni sawa na Kichwa cha 8 cha Kanuni za Marekani (Wageni na Raia).	External Regulation and Reputation	sw	14.0
Mahitaji na changamoto za kuendeleza usawa wa kijinsia na usawa ni dhahiri duniani kote.	Fairness and Equality	sw	4.0
Amepata uongozi bora na uwezo katika ngazi za juu za kisiasa, ikiwa ni pamoja na serikali ya Marekani, Ikulu ya Marekani, Wizara ya Mambo ya Nje na ujumbe wa Marekani kwa Umoja wa Mataifa, Shirika la Maendeleo ya Kimataifa (USAID), na Idara ya Afya. . Rasilimali watu. na Huduma za Binadamu (HHS).	Fairness and Equality	sw	4.0
Huku utawala wa Trump ukiendelea kushambulia masuala ya kijinsia, hasa afya ya ngono na uzazi na haki za LGBTQI+, utawala wa Biden unakabiliwa na sharti la kimkakati ili kuendeleza usawa wa kijinsia unaohitajika ili kufikia malengo ya afya na maendeleo ya Marekani. Hii inaonyesha kuwa ustawi wa kiuchumi na usalama wa taifa unaweza kupatikana.	Fairness and Equality	sw	4.0
Wakati tawala zingine zina ofisi maalum kwa wanawake na wasichana, Baraza la Sera ya Jinsia ya Ikulu ya sasa ni baraza la kwanza la kisiasa chini ya Rais kuzingatia usawa wa kijinsia na usawa wa kijinsia, pamoja na wanawake na wasichana, lakini linajumuisha zaidi na linajumuisha zaidi. . Ajenda ya jinsia, ikijumuisha masuala ya LGBTQI+.	Fairness and Equality	sw	4.0
Ikulu ya Marekani inaweza kuwa na jukumu la kuandaa na kuratibu michakato ya mashirika ambayo inapaswa kudhibiti mivutano na ushindani kati ya mashirika na taasisi na kuhitaji usaidizi wa kibinafsi wa ngazi ya juu kutoka kwa utawala.	Fairness and Equality	sw	4.0
Kulingana na Chama cha Wafanyabiashara, Tofauti, Usawa na Ujumuisho wa Marekani (mara nyingi hujulikana kama DEI) ni mfumo wa maendeleo ya jamii unaoweza kutumika katika mazingira ya biashara.	Fairness and Equality	sw	4.0
Gonjwa hilo limezidisha changamoto za kiafya na kiuchumi zinazowakabili wahamiaji, na kukidhi mahitaji ya wahamiaji kunakuwa muhimu zaidi huku shughuli za wahamiaji zikikua kwenye mpaka wa Amerika na Mexico.	Health and Safety	sw	9.0
Ingawa raia wengi ambao sio wazee wanaishi katika kaya zilizo na wafanyikazi wa wakati wote, wana ufikiaji mdogo wa bima ya kibinafsi kwa sababu wana uwezekano mkubwa wa kufanya kazi katika kazi zenye malipo duni na viwanda ambavyo waajiri wana uwezekano mdogo wa kutoa pensheni. - Ripoti ya ufadhili.	Health and Safety	sw	9.0
B. Baadhi ya wahamiaji, kama vile Wenye Hali Iliyolindwa kwa Muda, wako kisheria lakini hawastahiki kupata Medicaid au CHIP, kulingana na muda wanaokaa nchini.	Health and Safety	sw	9.0
Watu walio na hali ya DACA hawachukuliwi kuwa wamestahiki kisheria kupata bima ya afya na hawastahiki chaguo za bima chini ya sheria zinazotolewa na Vituo vya Huduma za Medicare na Medicaid (CMS).	Health and Safety	sw	9.0
Hata kama wanastahiki, familia nyingi za wahamiaji husalia bila bima kutokana na vikwazo vingi vinavyowakabili wakati wa kujiandikisha, ikiwa ni pamoja na hofu, kuchanganyikiwa kuhusu mchakato wa kustahiki, matatizo katika mchakato wa usajili, na lugha na kusoma na kuandika.	Health and Safety	sw	9.0
Utafiti unaonyesha kuwa mabadiliko ya sera ya uhamiaji ya utawala wa Trump yanasababisha familia za wahamiaji kutafuta kujiandikisha wenyewe na/au watoto wao katika Medicaid na CHIP ingawa wanastahiki.	Health and Safety	sw	9.0
"Jennifer Chacon: ""Mataifa yamepitisha sheria iliyoundwa kuzuia vikundi vyote kuvuka mipaka ya serikali, pamoja na wale walio na rekodi ya uhalifu, wapokeaji wa ruzuku za serikali, watumwa na weusi huru."""	Legality, Constitutionality, Jurisdiction	sw	5.0
"""Amanda Frost ni nyongeza bora kwa kitivo chetu kutokana na ujuzi na uzoefu wake katika uhamiaji na sheria ya kikatiba,"" Dean Risa Goluboff alisema."	Legality, Constitutionality, Jurisdiction	sw	5.0
"""Wazo la kitabu hiki lilinijia nilipoangalia hadithi za watu ambao wamepoteza uraia wao katika historia yote ya Amerika na kugundua kuwa hili ni jambo kubwa zaidi kuliko nilivyofikiria hapo awali,"" Frost alisema."	Legality, Constitutionality, Jurisdiction	sw	5.0
"Baada ya kuona mfumo wa haki ya jinai ukifanya kazi, alitaka ""kuwa sehemu yake na kuwakilisha watu ambao hawataki sauti zao zisikike."" Baada ya chuo kikuu, alifanya kazi kama mwanasheria wa haki za kiraia kwa mwaka mmoja. Aliomba elimu ya sheria katika taasisi na shule, ambayo alihitimu."	Legality, Constitutionality, Jurisdiction	sw	5.0
"""Ninaona masuala [ya uhamiaji] yanavutia katika nyanja zote, kutoka kwa masuala ya kisiasa hadi tafsiri za kisheria hadi maswali magumu ya kikatiba kuhusu uhusiano kati ya matawi matatu ya serikali,"" alisema."	Legality, Constitutionality, Jurisdiction	sw	5.0
Serikali za majimbo zina uwezo wa kutekeleza sheria za shirikisho za uhamiaji kwa kuwakamata wahamiaji walio na hatia za uhalifu hapo awali.	Legality, Constitutionality, Jurisdiction	sw	5.0
"Unamtazama afisa na kusema, ""Je, huwezi kunitazama tu na kusema niko sawa?"" unaweza kufikiria. Kwa bahati mbaya, sivyo. Inatosha"	Morality	sw	3.0
Kwa hivyo, ikiwa unavuta bangi ya matibabu au bangi ya burudani, unaweza kuchukuliwa kuwa umepotoka kimaadili, hata ikiwa ni halali katika jimbo lako na hujawahi kukamatwa au kuhukumiwa kwa dutu inayodhibitiwa.	Morality	sw	3.0
Tabia ya maadili na mkazi halali wa kudumu (LPR). Iwapo wewe ni Mkazi Halali wa Kudumu (LPR) na ungependa kutuma maombi ya uraia/uraia wa Marekani, ni lazima uonyeshe tabia nzuri ya kiadili kwa maafisa wa USCIS wakati wa makazi yako halali ya kudumu.	Morality	sw	3.0
Maadili na utaratibu katika mahakama za uhamiaji. Wakati mtu yuko chini ya kufukuzwa nchini au kufukuzwa na USCIS, lazima aonyeshe tabia nzuri ya maadili.	Morality	sw	3.0
Katika mfano wa kawaida wa mtu anayeomba uraia wa Marekani kutokana na jeraha mbaya au unyanyasaji wa kihisia, ushahidi wa mafanikio makubwa wakati wa kukaa Marekani unaweza kudhoofisha kesi nzima ya mtu huyo.	Morality	sw	3.0
Ikiwa hawatatuma maombi ndani ya mwaka wa kwanza, wanapoteza nafasi yao ya hifadhi.	Other	sw	15.0
Zaidi ya Waafghani 200,000, Waukraine, Wavenezuela, Wanicaragua, Wacuba na Wahaiti wamekamilisha majaribio rasmi zaidi ya kibinadamu.	Other	sw	15.0
Maafisa wa White House na Usalama wa Ndani walianza kujadili mzozo wa wahamiaji na vikwazo zaidi kwa wahamiaji wanaoingia Merika kati ya mpaka wa Amerika na Mexico.	Other	sw	15.0
"""Kwa upande wa utawala, tunazingatia masuala yote ya kisheria kabla ya kuanza sera, na sheria mpya zinazopendekezwa zinaonyesha mambo hayo,"" afisa wa serikali alisema katika taarifa."	Other	sw	15.0
Pendekezo la kurekebisha mfumo wa uhamiaji limekwama huku mamlaka ikihofia idadi ya wahamiaji wanaofika kwenye mpaka wa kusini wa Marekani, vyanzo viliiambia CNN.	Other	sw	15.0
"""Siyo kipaumbele chetu cha juu, sio kipaumbele chetu cha pili,"" afisa wa utawala aliwaambia waandishi wa habari hapo awali, akionyesha jitihada za kufungua upatikanaji wa kisheria wa matumizi ya programu nchini Marekani na kubainisha kuwa kura ya mageuzi inategemea mswada huo. pamoja na Congress. ."	Other	sw	15.0
Kama sehemu ya uchunguzi wa kimatibabu wa uhamiaji, mwombaji, daktari wa upasuaji wa kiraia, na wataalamu wengine wote wa matibabu wanaomtathmini mwombaji lazima atie sahihi kwenye fomu na kuthibitisha kwamba wanachosema ni kweli.	Policy Prescription and Evaluation	sw	6.0
Ikiwa mkimbizi anahitaji tu mtihani wa chanjo, fomu lazima ijazwe: taarifa ya maombi, mtihani wa chanjo na cheti.	Policy Prescription and Evaluation	sw	6.0
Huduma za Uraia na Uhamiaji za Marekani (USCIS) hukubali waombaji walio na ulemavu mahususi wa kimwili, kiakili au ukuaji wakati mwombaji mwingine aliye na ulemavu au ugonjwa sawa anastahiki msamaha wa ulemavu.	Policy Prescription and Evaluation	sw	6.0
Msamaha wa ulemavu unaweza kupatikana tu kwa kuwasilisha Fomu N-648, ambayo inahitaji uthibitisho kwamba ulemavu wa kimwili au kiakili au ulemavu wa kiakili wa mwombaji humzuia mwombaji kukidhi matakwa ya lugha ya Kiingereza au uraia, au zote mbili. Malazi yanayokubalika.	Policy Prescription and Evaluation	sw	6.0
Wakalimani wanaotoa huduma za ukalimani wa uchunguzi wa kimatibabu wa telemedicine hawatakiwi kujaza Fomu N-648, Uthibitishaji wa Mkalimani.	Policy Prescription and Evaluation	sw	6.0
Kwa miaka mingi, Congress imeshindwa kukubaliana juu ya mageuzi ya kina ya uhamiaji, kubadilisha kwa ufanisi baadhi ya maamuzi muhimu ya sera kwa mtendaji na mahakama na kuchochea mjadala katika nyumba za serikali na za mitaa.	Political	sw	13.0
Hatua za Biden za kubadilisha sera katika enzi ya Trump ni pamoja na kulegeza vizuizi vya uhamiaji vya Marekani, kuondoa marufuku ya kusafiri, kuondoa kusitisha usindikaji wa kadi za kijani, na kusimamisha ujenzi wa ukuta kwenye mpaka wa Marekani na Mexico.	Political	sw	13.0
Wakati huo huo, wimbi la kihistoria la wahamiaji kwenye mpaka wa kusini unatishia kudhoofisha zaidi juhudi za Biden, na kukamatwa kwenye mpaka kufikia karibu 240,000 mnamo Mei 2022, kiwango cha juu cha miaka 20 tangu kudorora kwa janga hilo.	Political	sw	13.0
Katika Mkutano wa Kilele wa Nchi za Amerika wa 2022, viongozi 23 wa Ulimwengu wa Magharibi walikubaliana juu ya mkataba wa uhamiaji ili kuongeza misaada kwa wakimbizi, kuboresha usimamizi wa mpaka na kuratibu vyema kukabiliana na dharura.	Political	sw	13.0
Biden na Rais wa Mexico Andres Manuel López Obrador pia walitembelea Amerika Kusini. Mpango wa pamoja wa miundombinu ya usalama wa mpaka unapendekezwa kupanua visa vya kazi vya muda na kuongeza uwekezaji katika ufuatiliaji wa mpaka.	Political	sw	13.0
"""Kabla ya miaka ya 1920, mwelekeo wa jumla katika mjadala kuhusu uhamiaji ulikuwa mbaya, lakini ndani ya kizazi kimoja - kutoka 1945 hadi 1965 - ulikuwa mzuri sana,"" alisema profesa wa uchumi na mwanahistoria wa kiuchumi Ron Abramicki. Chuo Kikuu cha Stanford kinashirikiana na watafiti wa AI ili kuchapisha kazi mpya."	Public Sentiment	sw	12.0
Mbali na Kadi na Abramicki, timu hiyo inajumuisha mwanasayansi wa kompyuta wa Stanford Serena Chang. Chris Baker ni mchumi katika Stanford. Julia Mendelsohn ni mwanasayansi wa data katika Chuo Kikuu cha Michigan. Dan Jurafsky ni Profesa wa Isimu na Sayansi ya Kompyuta huko Stanford. ; Profesa; Rob Voigt ni profesa msaidizi wa isimu katika Chuo Kikuu cha Northwestern.	Public Sentiment	sw	12.0
Ili kuunda muundo wa mashine ya kujifunza ambao unaweza kutambua kwa usahihi sauti za wahamiaji, timu ilitathmini mwenyewe sampuli za hotuba za watafiti ili kubaini kama zilikuwa chanya, hasi au zisizoegemea upande wowote na jinsi zilivyowakilisha wahamiaji.	Public Sentiment	sw	12.0
Mtazamo wa kuunga mkono wahamiaji katika mazungumzo ya hivi majuzi ya kisiasa unaonyesha mtazamo chanya unaoongezeka kote nchini.	Public Sentiment	sw	12.0
Kama ilivyoripotiwa mwezi uliopita, uhamiaji haramu ni suala la pili kwa ukubwa wa umma katika masuala ya rangi kati ya masuala 14 yaliyopitiwa mwaka huu.	Public Sentiment	sw	12.0
"""Hatuna haja ya kumshinikiza Rais Biden juu ya marufuku ya hifadhi, tunahamasisha watu kupaza sauti zao dhidi ya dhuluma hii mbaya,"" Bilal Asyar, kaimu mkurugenzi wa kampeni wa muungano wa #WelcomeWithDignity. Sheria ya uhamiaji na taasisi za kisheria."	Public Sentiment	sw	12.0
Shirika la Afya Ulimwenguni linafafanua ubora wa maisha kama tathmini ya kibinafsi ya mtazamo wa mtu wa ukweli wa malengo yake kupitia prism ya utamaduni wa mtu na mfumo wa thamani.	Quality of Life	sw	10.0
Hii itagharimu mfumo wetu wa hifadhi mamilioni ya dola katika gharama za usimamizi na usaidizi wa kisheria kwa wale wanaotumia mfumo vibaya kwa madai yasiyothibitishwa, ya uwongo au hasidi - tazama muhtasari wetu kuhusu mzigo unaokua na gharama za kutumia vibaya mfumo wa hifadhi.	Quality of Life	sw	10.0
"Msongamano unazidi kuwa mbaya: London sasa ndilo jiji lenye shughuli nyingi zaidi ulimwenguni, na kuongezeka kwa msongamano kumesababisha uamuzi unaoongozwa na serikali wa kubadili ""barabara kuu zenye akili,"" kampuni ya data ya trafiki Enrix imegundua. Kupunguza usalama wa kuendesha gari na kuweka familia katika hatari, kuondoa bega ngumu."	Quality of Life	sw	10.0
Bila kusahau jinamizi la usalama wa raia linalotokana na kushindwa kuwafuatilia maelfu ya wahamiaji haramu wanaoingia nchini kwa boti, ndege na malori, na tabia ya kuharibu kwa makusudi utambulisho wa wanaoingia nchini. .	Quality of Life	sw	10.0
Sheria zinazobagua watu wasio raia, pamoja na programu na sera ambazo hazizingatii mahitaji yao maalum na udhaifu, mara nyingi huwanyima familia na familia zao kupata huduma zinazohitajika.	Quality of Life	sw	10.0
Uwezo wa mwanamke kuhama unaweza kuzuiwa na mambo ya kibinafsi na ya familia kama vile umri, historia ya familia, rangi/kabila, hali ya ndoa na kuwepo au kutokuwepo kwa watoto.	Quality of Life	sw	10.0
Wahamiaji wanadharauliwa, wananyanyapaliwa, wanazuiliwa kiholela, na wakati mwingine wanatengwa na watoto wao kwa sababu ya imani zao za kikabila.	Quality of Life	sw	10.0
Vizuizi na kuta hutokea kutokana na imani kwamba kuzuia njia salama na zenye utaratibu wa kusafiri na kuziimarisha kimakusudi kutafanya watu wasiwe na nia ya kuondoka katika ardhi zao.	Quality of Life	sw	10.0
Wahamiaji lazima waonyeshe kwamba wanaogopa mateso wanaporudi.	Quality of Life	sw	10.0
Idadi hiyo iliamuliwa na watu waliopiga kura kote nchini kuhusu mada mbalimbali, ikiwa ni pamoja na uwezo wa kumudu nyumba, gharama ya maisha, muda wa kusafiri, uchafuzi wa mazingira, uhalifu, afya, uwezo wa kumudu gharama, burudani na ajira.	Quality of Life	sw	10.0
Tangu tarehe 9/11, Idara ya Usalama wa Taifa (DHS) na serikali ya shirikisho, pamoja na washirika wao wengi katika sekta ya umma na ya kibinafsi, na pia katika jumuiya za kitaifa na kimataifa, wamefanya kazi kurejesha na kuboresha kwa kiasi kikubwa kile ambacho kilikuwa kipya. . Nchi ya mama. Usalama ni usalama wa kimwili. Vitisho Vinavyobadilika huongeza uwezo wako wa kupunguza, kujibu, na kupona kutokana na aina zote za mashambulizi na kuacha kufanya kazi.	Security and Defense	sw	8.0
Shirika la Huduma za Uraia na Uhamiaji nchini Marekani (USCIS) limesasisha vibali vyake vya kufanya kazi ili kujumuisha eneo linaloweza kusomeka kwa mashine ambayo inaruhusu maafisa wa udhibiti wa mpaka kutambua kwa njia ifaayo watu ambao wameidhinishwa kuhama na ambao hapo awali walikaguliwa na maafisa wa USCIS.	Security and Defense	sw	8.0
WE. Walinzi wa Pwani huongeza uwezo wa Jeshi la Wanamaji kujibu vitisho kwa kujenga vikosi muhimu vya Amerika, vikiwemo vikosi vya mapigano, vikosi vya kukabiliana na ugaidi, na uwepo na uwekaji wa silaha za maangamizi makubwa. Uwezo wa kujibu haraka kwa amri za usalama za baharini na bandari. Vitisho vya usogezaji wa ndani na majibu yanayofuata.	Security and Defense	sw	8.0
Utambuzi wa Mionzi: CBP imetekeleza skrini za mionzi na teknolojia nyingine za kutambua mionzi kwenye bandari, mipaka ya nchi kavu na ofisi za posta duniani kote.	Security and Defense	sw	8.0
Tangu tarehe 9/11, Idara ya Usalama wa Taifa (DHS) na serikali ya shirikisho, pamoja na washirika wao wengi katika sekta ya umma na ya kibinafsi, na pia katika jumuiya za kitaifa na kimataifa, wamefanya kazi kurejesha na kuboresha kwa kiasi kikubwa kile ambacho kilikuwa kipya. . Nchi ya mama. Usalama ni usalama wa kimwili. Vitisho Vinavyobadilika huongeza uwezo wako wa kupunguza, kujibu, na kupona kutokana na aina zote za mashambulizi na kuacha kufanya kazi.	Security and Defense	sw	8.0
"Wasomaji wa kisasa wanaweza kufahamu harusi za ""mwanamume na mwanamke"" zilizopangwa na vilabu vya wanaume na wanawake mwanzoni mwa karne ya 20 ili kuongeza fedha kwa vifungo vya Uhuru."	Capacity and Resources	sw	2.0
Chunguza vipengele vya kitamaduni vya ushoga kama vile Yesu, harusi yake ya kufikiria, na hadithi ya Mark Twain ya jinsi alivyofunga ndoa na Kate Wilson, ambaye kazi yake Nancy Jackson hakuthubutu kuchapisha.	Capacity and Resources	sw	2.0
"Baada ya Usikilizaji wa Kibinafsi: Jaji wa Mauaji wa Chicago wa 1923 aliamua kwamba ""Thompson kuwa mwanamume hakuathiri hali yake kama mume, ambalo lilikuwa suala la tafsiri ya kisheria."" Thompson hakuruhusiwa kutoa ushahidi. kwa maana ndipo mwanamke awezaye kumshuhudia mumewe.”"	Capacity and Resources	sw	2.0
Wanandoa wa jinsia moja - kama vile wanandoa wanaofanana, wanandoa waliochanganyika, wanandoa wanaoishi pamoja, na mitala - inaweza kuwa halali au isiwe ya kisheria machoni pa serikali, lakini zipo.	Capacity and Resources	sw	2.0
"Kama Cliffs anavyouliza, ""Je, wanafaa kueleweka kama mashoga au bado wanafaa katika historia ya watu waliobadili jinsia iliyofafanuliwa na historia ya mashoga na wasagaji?"	Capacity and Resources	sw	2.0
Watu wa LGBTQ+ ambao tayari wamefunga ndoa wanasema marufuku bado inawaruhusu kuoa	Crime and Punishment	sw	7.0
Watu wa LGBTQ+ wanaotaka kuoa katika majimbo 32 ambayo hayana haki sawa za ndoa lazima waoe nje ya serikali na serikali yao lazima itambue muungano wao.	Crime and Punishment	sw	7.0
Je, mswada huo unamaanisha nini kwa wale wanaooa katika majimbo ambayo ndoa za LGBTQ+ ni haramu?	Crime and Punishment	sw	7.0
Ikiwa Mahakama ya Juu itabatilisha usawa wa ndoa, je, kuna njia ya kurejesha usawa wa ndoa kote nchini?	Crime and Punishment	sw	7.0
"Clarence Thomas, mmoja wa majaji walio wengi waliobatilisha uamuzi wa Rowe, aliandika maoni akihoji kwamba mahakama inapaswa ""kumtazama upya"" Obergefell, na kuyataja kuwa moja ya maamuzi mbovu ya mahakama. Safu hukaa kwa muda mfupi sana kabla ya kuendelea."	Crime and Punishment	sw	7.0
Wapenzi wa jinsia moja wameshinda vita vya usawa wa ndoa na wanafurahia manufaa mengi, kama si yote, chini ya sheria ya shirikisho na serikali.	Economic	sw	1.0
Katika baadhi ya majimbo na Wilaya ya Columbia, wanandoa wanaweza kumiliki mali, kama vile nyumba zao na akaunti za benki, ambayo inaweka kikomo jinsi wadai wanaweza kunyakua mali fulani yenye jina.	Economic	sw	1.0
Kwa washirika wa maisha ambao hawajaoana ambao hupokea manufaa sawa ya mfanyakazi (ikiwa mwajiri pia hulipa faida ya mwenzi wa maisha), gharama ya faida ya mwenzi wa maisha kwa ujumla ni sawa na mapato yanayotozwa ushuru ya mfanyakazi kwenye kodi ya mapato ya shirikisho.	Economic	sw	1.0
Sasa kwa kuwa ndoa ya watu wa jinsia moja inatambulika, wapenzi wa jinsia moja wanaweza kufurahia faraja ya kujua kwamba wako upande wao kisheria linapokuja suala la kufanya maamuzi kuhusu wenzi hao wagonjwa na kudhibiti mali za wenzi wao. Kifo kwa kutokuwepo kwa mipango mingine.	Economic	sw	1.0
Madhara ya kiuchumi ya ndoa za watu wa jinsia moja yanaathiri vyema uchumi wa serikali na wa ndani, pamoja na sekta ya harusi.	Economic	sw	1.0
Mashirika ya kimataifa, ikiwa ni pamoja na UN, yamepitisha maazimio ya kuunga mkono haki za LGBTQ+, lakini mashirika ya haki za binadamu yanasema uwezo wao wa kutekeleza ni mdogo.	External Regulation and Reputation	sw	14.0
"""Hakuna mwanadiplomasia mwenye akili timamu ambaye angependa kutembelea nchi ambayo haiko tayari kwa ndoa za jinsia moja,"" Dorf alisema."	External Regulation and Reputation	sw	14.0
Huku uungwaji mkono wa umma kwa ndoa za jinsia moja ukiongezeka, mjadala unaendelea kati ya watu binafsi na mashirika yanayounga mkono usawa wa kisheria na wale wanaopinga usawa wa ndoa kulingana na dini.	External Regulation and Reputation	sw	14.0
Mwishoni mwa karne ya 20, kuhalalishwa kwa mitazamo dhidi ya ushoga na sheria zinazodhibiti tabia ya ushoga, haswa katika Ulaya Magharibi na Merika, kulisababisha kuongezeka kwa hamu ya kitaaluma na ya umma katika mada hii.	Cultural Identity	sw	11.0
Mwanzoni mwa miaka ya 2000, nchi nyingi na mamlaka za mitaa zilihalalisha ndoa za jinsia moja. Mamlaka nyingine zimechukua hatua za kikatiba kupiga marufuku ndoa za jinsia moja au kupitisha sheria za kuzuia utambuzi wa ndoa hizo kufanywa kwingineko.	Cultural Identity	sw	11.0
Ukweli kwamba vikundi tofauti huchanganua tabia moja kwa njia tofauti huonyesha umuhimu wake kama shida ya kijamii mwanzoni mwa karne ya ishirini na moja. Pia inaonyesha kuwa kuna tofauti za kitamaduni ndani na kati ya nchi.	Cultural Identity	sw	11.0
Fomu ya kawaida ya hati ni ndoa ya kiraia. Ndoa za Morgan ambazo hatimiliki na mali hazipitishi kwa watoto. Ndoa ya kubadilishana ambayo ndugu mmoja kutoka familia moja anaoa ndugu mwingine. na ndoa inayotokana na mitala (mchumba) au ndoa ya ukoo. mitala (mke).	Cultural Identity	sw	11.0
Matarajio ya kidini na ya kilimwengu ya ndoa na ngono\nBaada ya muda, historia na utamaduni wa jadi ulioandikwa na Bachofen na Morgan, miongoni mwa wengine, pole pole uliathiriwa na ulinganifu uliowekwa na ukoloni.	Cultural Identity	sw	11.0
Mashirika ya kimataifa, ikiwa ni pamoja na UN, yamepitisha maazimio ya kuunga mkono haki za LGBTQ+, lakini mashirika ya haki za binadamu yanasema uwezo wao wa kutekeleza ni mdogo.	Fairness and Equality	sw	4.0
Wakati huo huo, katika jamhuri ya Chechnya yenye uhuru wa nusu ya Urusi, makumi ya wanaume wanaoshukiwa kufanya ushoga wamekamatwa, kuteswa na kuuawa tangu 2017 katika operesheni mbili tofauti za serikali.	Fairness and Equality	sw	4.0
Wabunge nchini Thailand na Vietnam wanazingatia miswada ya kuhalalisha ndoa za watu wa jinsia moja au kuishi pamoja.	Fairness and Equality	sw	4.0
Kulingana na ILGA, uungaji mkono wa kuhalalisha ndoa za jinsia moja pia ni wa chini kabisa katika Karibea, kwa asilimia 16 nchini Jamaica na asilimia 23 katika Jamhuri ya Dominika.	Fairness and Equality	sw	4.0
Mahusiano ya kisheria ya wanandoa, wazazi, na watoto pia yalielekea kuingiliana katika vikundi ambapo ndoa za jinsia moja zilikuwa na matatizo makubwa.	Health and Safety	sw	9.0
Kinyume na mtindo huria wa ndoa, watetezi wa ndoa ya kisheria ya jinsia moja mara nyingi huamini kwamba miungano kamili inayohusisha urafiki wa kingono ni ya thamani kwa sababu huwaleta watu pamoja kwa njia za kipekee na za kipekee.	Health and Safety	sw	9.0
Baadhi ya nchi nyingine zina katiba za Kiislamu ambazo mara nyingi hufasiriwa kuwa zinakataza wapenzi wa jinsia moja kuoana.	Legality, Constitutionality, Jurisdiction	sw	5.0
Huko Merika, ndoa ya jinsia moja ikawa hitaji rasmi la harakati za haki za mashoga baada ya Machi ya Pili ya Haki za Mashoga huko Washington mnamo 1987.	Legality, Constitutionality, Jurisdiction	sw	5.0
Katika nchi nyingine, katiba zilizopitishwa zina lugha kwamba ndoa ni kati ya mwanamume na mwanamke, wakati hakuna lugha inayokataza ndoa za jinsia moja, hasa katika katiba za zamani.	Legality, Constitutionality, Jurisdiction	sw	5.0
Pia walisema kuwa uingizwaji wa ndoa za jinsia moja kwa sheria tofauti, kama vile kuishi pamoja, haukubaliki na ni ubaguzi.	Legality, Constitutionality, Jurisdiction	sw	5.0
Ingawa yametengwa, baadhi ya mashirika yanatambua kikamilifu vyama vya watu wa jinsia moja.	Legality, Constitutionality, Jurisdiction	sw	5.0
Ingawa ndoa za watu wa jinsia moja hudhibitiwa na sheria, dini na mila katika sehemu nyingi za dunia, miitikio ya kisheria na kijamii huanzia kutukuza kwa upande mmoja hadi kuharamishwa kwa upande mwingine.	Morality	sw	3.0
Mwishoni mwa karne ya 20 na mwanzoni mwa karne ya 21, maoni ya dini moja au zaidi za ulimwengu (Ubudha, Uhindu, Uyahudi, Uislamu na Ukristo) na desturi zao za sheria za kiraia mara nyingi zimetajwa katika mijadala ya kitaifa kuhusu ndoa za watu wa jinsia moja.	Morality	sw	3.0
Hata nchini Iran, ambako imani kali za kidini za Kiislamu zinaharamisha ushoga, na hata nchini Denmark, ambapo matokeo ya mkutano wa maaskofu wa Kiinjili wa Kilutheri (wawakilishi wa dini ya serikali) hufungua njia kwa ngazi ya kwanza ya kutambuliwa kitaifa. Mahusiano ya watu wa jinsia moja kupitia ushirikiano uliosajiliwa.	Morality	sw	3.0
Katika hali nyingine, kanuni ya usawa wa kitamaduni inayokuzwa na dini kuu haijahamia katika ulimwengu wa kisiasa, hata ikiwa imezua mjadala wa kihisia kati ya wananchi: nchini Ubelgiji na Hispania, kwa mfano, uhalali wa ndoa za jinsia moja huja. mbele. kucheza? Shirika la kidini, Kanisa Katoliki la Roma.	Morality	sw	3.0
Lakini kesi ya Mahakama ya Juu Roe v. Uamuzi wa Wade uliibua wasiwasi mpya kwamba mahakama ya juu zaidi nchini itazingatia haki nyingine zinazohusiana na usawa wa ndoa. .	Other	sw	15.0
"Maneno ""hakuna mipango kwa miaka michache ijayo"" yaliwakilisha maendeleo ya kushangaza ya kibinafsi kwa mkazi wa muda mrefu wa Washington, ikizingatiwa msisitizo wa Biden wakati seneta huyo alipopiga kura kuzuia serikali ya shirikisho kutambua ndoa za jinsia moja, ambayo hapo awali alikuwa amesisitiza tu. Hali ya wanaume na wanawake ndani."	Other	sw	15.0
Vurugu na chuki bado zipo. Vitabu vilivyo na mandhari na wahusika wa LGBTQ kuhusu haki za trans, wanariadha wa kimataifa, huduma ya afya inayothibitisha jinsia, na shule za vijana wanaovuka mipaka.	Policy Prescription and Evaluation	sw	6.0
Wanasiasa nyemelezi wa mrengo wa kulia hupata mamlaka kwa kuingiza woga usio na msingi katika jamii zilizotengwa ambazo hazielewi masuala haya na kisha kujilinda dhidi ya malengo yao.	Policy Prescription and Evaluation	sw	6.0
"Sasha Eisenberg, mwandishi wa Engagement: America is a Quarter the Same, alisema: “Kama mgombea urais na makamu wa rais wa Seneti, amekuwa akihofia masuala ya LGBT na kuogopa kuchukua msimamo wowote ambao wapinzani wake wanaweza kutumia kumuonyesha. kama mtu wa kushoto."" - Ndoa za ngono wakati wa Vita vya Miaka Mia, laripoti CNN."	Policy Prescription and Evaluation	sw	6.0
Judith Carson-Windsor, mke wa mwanaharakati wa haki za mashoga Eddie Windsor. Matthew Haynes, mmiliki mwenza wa Club Q, klabu ya LGBT huko Colorado Springs, aliuawa kwa kupigwa risasi kwa wingi mwezi uliopita. 5? Walionusurika kwenye Klabu ya Risasi Q James Sloa na Michael Anderson; Walalamikaji kadhaa katika kesi ya kihistoria ya haki za kiraia ya Obergefell v. Hodges, ambayo ilitawala mnamo 2015 kwamba wapenzi wa jinsia moja wanaweza kuoana kote nchini.	Policy Prescription and Evaluation	sw	6.0
Baraza la Wawakilishi Alhamisi lilipitisha sheria inayolinda ndoa za watu wa jinsia moja na watu wa rangi tofauti. Hii ni hatua ya mwisho kabla ya mswada huo kwenda kwa Rais Joe Biden kwa ajili ya kutia saini yake na kuwa sheria.	Policy Prescription and Evaluation	sw	6.0
Rais Joe Biden alitia saini ulinzi mpya wa kihistoria wa shirikisho kwa watu wa jinsia moja na wapenzi waliochanganyika Jumanne, na kuzuia maendeleo ya kibinafsi na ya kitaifa kuhusu suala ambalo limekubalika zaidi katika muongo mmoja uliopita.	Political	sw	13.0
Biden alitia saini Sheria ya Huduma ya bei nafuu mbele ya maelfu ya wageni kwenye Lawn Kusini, ambayo White House ilisema inaonyesha umuhimu wa wakati huo.	Political	sw	13.0
Ingawa maoni ya umma kuhusu ndoa za jinsia moja yamebadilika kwa miaka mingi, kuna uwezekano kwamba sheria kama hiyo itapitishwa huko Washington: Kulingana na kura ya maoni isiyo ya faida, asilimia 68 ya Wamarekani waliunga mkono ndoa za jinsia moja mwaka 2021, kutoka 14 mwaka 2014. Asilimia ya dini ya umma imeongezeka katika mwaka uliopita.	Political	sw	13.0
"Maneno ""hakuna mipango kwa miaka michache ijayo"" yaliwakilisha maendeleo ya kushangaza ya kibinafsi kwa mkazi wa muda mrefu wa Washington, ikizingatiwa msisitizo wa Biden wakati seneta huyo alipopiga kura kuzuia serikali ya shirikisho kutambua ndoa za jinsia moja, ambayo hapo awali alikuwa amesisitiza tu. Hali ya wanaume na wanawake ndani."	Political	sw	13.0
"""Unaona, kulikuwa na uungwaji mkono mzuri sana wa pande mbili katika Baraza la Wawakilishi jana, na ninatumai mtauona katika Seneti,"" alisema."	Political	sw	13.0
Takriban nusu (51%) ya watu walio na elimu ya chini ya sekondari wanasema ndoa ya jinsia moja ni nzuri sana (26%) au inatosha (25%) kwa jamii, wakati 45% (20%) wanafikiri sivyo. Mbaya sana (24%).	Public Sentiment	sw	12.0
Ingawa tofauti za upendeleo zinaonekana bila kujali umri wa Marekani na mafanikio ya elimu, tofauti hizi ni za kawaida zaidi kati ya vijana kuliko wazee.	Public Sentiment	sw	12.0
Vijana wa Republican walionyesha mitazamo chanya zaidi kuhusu ndoa za jinsia moja kuliko Warepublican wakubwa, wakati pengo la umri lilikuwa ndogo kati ya Wanademokrasia.	Public Sentiment	sw	12.0
Pengo la elimu ni kubwa kidogo kwa Wanademokrasia kuliko Republican.	Public Sentiment	sw	12.0
Hata Wanademokrasia wakuu kama vile Rais wa zamani Barack Obama walisita kuunga mkono ndoa za watu wa jinsia moja—Obama aliishia kuwa rais wa kwanza kufanya hivyo.	Public Sentiment	sw	12.0
Ingawa usaidizi wa ndoa za jinsia moja umeongezeka kutoka kizazi hadi kizazi katika kipindi cha miaka 15 iliyopita, pengo la umri bado ni kubwa.	Quality of Life	sw	10.0
Kwa mfano, 45% ya watu wazima katika Kizazi Kimya (kilichozaliwa 1928-1945) wanaruhusu ndoa za jinsia moja, wakati 74% ya milenia (waliozaliwa 1981-1996) wanakubali ndoa za jinsia moja.	Quality of Life	sw	10.0
Kura ya maoni ya Gallup ya 2017 iligundua kuwa mmoja kati ya Wamarekani kumi wa LGBT (10.2%) alifunga ndoa na mwenzi wa jinsia moja katika miezi iliyotangulia uamuzi wa Mahakama ya Juu (7.9%).	Quality of Life	sw	10.0
Kura mpya iliyofanywa kabla ya uchaguzi wa katikati ya muhula wa Oktoba iligundua kuwa Mahakama ya Juu katika Roe v. Baada ya Wade kutengua uamuzi wake, aliibua maswali kuhusu iwapo ndoa za watu wa jinsia moja ni halali nchini humo. Sheria za uavyaji mimba zinarejea majimboni.	Quality of Life	sw	10.0
Kituo cha Utafiti cha Pew kilihoji umma kuhusu hali ya kisheria ya ndoa za watu wa jinsia moja.	Quality of Life	sw	10.0
Inahitaji majimbo kudumisha uhalali wa leseni za ndoa za nje ya serikali, ikijumuisha muungano wa watu wa jinsia moja na watu wa rangi nyingi.	Security and Defense	sw	8.0
"""Kutafuta furaha ni fursa ya kumpenda mtu yeyote,"" alisema."	Security and Defense	sw	8.0
Inafafanua kuwa taasisi za kidini hazilazimishi ndoa za watu wa jinsia moja na kwamba serikali haziwezi kuzilazimisha kulinda ndoa za wake wengi.	Security and Defense	sw	8.0
Baraza la Wawakilishi Jumanne lilipitisha sheria ya kuhalalisha ndoa za watu wa jinsia moja kote nchini na kuimarisha hatua nyingine za kulinda usawa wa ndoa, ikiwa ni jibu la moja kwa moja kwa uamuzi wa hivi majuzi wa Mahakama ya Juu ambao kwa muda mrefu uliondoa sheria za utoaji mimba kwa majimbo.	Security and Defense	sw	8.0
Kwa upande mmoja, madhumuni ya ndoa ni kuhakikisha uzazi na elimu ya watoto bila vikwazo.	Quality of Life	sw	10.0
